symbol,date,actual,predicted,MAPE,RMSE
شفن,2018-01-17,29333,29136,0.0067159854086961445,197
شفن,2018-01-20,29234,29333,0.0033864678113365784,99
شفن,2018-01-21,29188,29234,0.0015759901328773471,46
شفن,2018-01-22,29957,29188,0.025670127181437723,769
شفن,2018-01-23,30479,29957,0.017126546145965205,522
شفن,2018-01-24,30478,30479,3.281055187240598e-5,1
شفن,2018-01-27,30329,30478,0.004912789739031528,149
شفن,2018-01-28,30279,30329,0.001651309488369784,50
شفن,2018-01-29,30234,30279,0.0014883905536320569,45
شفن,2018-01-30,30216,30234,5.957108816323898e-4,18
شفن,2018-01-31,30002,30216,0.007132857809241622,214
شفن,2018-02-03,29946,30002,0.0018700327255102506,56
شفن,2018-02-04,29894,29946,0.0017394794941546974,52
شفن,2018-02-05,29973,29894,0.0026357054681668264,79
شفن,2018-02-06,29956,29973,5.674989985122346e-4,17
شفن,2018-02-07,30570,29956,0.020085050702646875,614
شفن,2018-02-10,30645,30570,0.00244738130192699,75
شفن,2018-02-12,30652,30645,2.2837009003561366e-4,7
شفن,2018-02-13,30725,30652,0.002375915378279059,73
شفن,2018-02-14,30760,30725,0.0011378413523687307,35
شفن,2018-02-17,30784,30760,7.796257796004539e-4,24
شفن,2018-02-18,31126,30784,0.010987598791653678,342
شفن,2018-02-19,31294,31126,0.005368441234569935,168
شفن,2018-02-21,31383,31294,0.002835930280634868,89
شفن,2018-02-24,31263,31383,0.0038384032241359305,120
شفن,2018-02-25,30971,31263,0.009428174743811043,292
شفن,2018-02-26,30842,30971,0.004182608131632753,129
شفن,2018-02-27,30758,30842,0.0027309968137482605,84
شفن,2018-02-28,30543,30758,0.007039256130470508,215
شفن,2018-03-03,30518,30543,8.191886755089066e-4,25
شفن,2018-03-04,30423,30518,0.0031226374781210715,95
شفن,2018-03-05,30191,30423,0.007684409260783531,232
شفن,2018-03-06,30012,30191,0.005964280954086223,179
شفن,2018-03-07,29718,30012,0.009892994144629753,294
شفن,2018-03-10,29739,29718,7.061434479738342e-4,21
شفن,2018-03-11,29648,29739,0.0030693470047534624,91
شفن,2018-03-12,30068,29648,0.013968338432420901,420
شفن,2018-03-13,30103,30068,0.0011626748164248522,35
شفن,2018-03-14,30091,30103,3.9879033596760524e-4,12
شفن,2018-03-17,30115,30091,7.969450439715443e-4,24
شفن,2018-03-18,29941,30115,0.005811429143789071,174
شفن,2018-03-19,29601,29941,0.01148609844223215,340
شفن,2018-03-25,29602,29601,3.3781501248774354e-5,1
شفن,2018-03-26,30054,29602,0.015039595394455327,452
شفن,2018-03-27,30470,30054,0.01365277321911215,416
شفن,2018-03-28,30492,30470,7.215007214770595e-4,22
شفن,2018-04-03,30495,30492,9.837678307596732e-5,3
شفن,2018-04-04,30853,30495,0.011603409716669257,358
شفن,2018-04-07,31078,30853,0.007239848123841951,225
شفن,2018-04-08,31180,31078,0.0032713277741093223,102
شفن,2018-04-09,32698,31180,0.04642485778804744,1518
شفن,2018-04-10,31064,32698,0.05260108163621552,1634
شفن,2018-04-11,30726,31064,0.011000455639816427,338
شفن,2018-04-15,30742,30726,5.204606076208295e-4,16
شفن,2018-04-16,30053,30742,0.022926163776563865,689
شفن,2018-04-17,30338,30053,0.009394159140042383,285
شفن,2018-04-18,30304,30338,0.0011219640971118676,34
شفن,2018-04-21,30276,30304,9.248249438193677e-4,28
شفن,2018-04-22,30224,30276,0.001720487030117771,52
شفن,2018-04-23,30197,30224,8.941285557871932e-4,27
شفن,2018-04-24,30161,30197,0.001193594376804695,36
شفن,2018-04-25,30060,30161,0.003359946773008651,101
شفن,2018-04-28,30036,30060,7.990411505926541e-4,24
شفن,2018-04-29,29800,30036,0.007919463086982569,236
شفن,2018-04-30,28857,29800,0.03267837959480617,943
شفن,2018-05-01,28714,28857,0.004980149056036075,143
شفن,2018-05-05,28515,28714,0.006978783096371076,199
شفن,2018-05-06,28460,28515,0.0019325368938182524,55
شفن,2018-05-07,28553,28460,0.0032571008299213007,93
شفن,2018-05-08,28579,28553,9.097589138559866e-4,26
شفن,2018-05-09,29009,28579,0.01482298596936044,430
شفن,2018-05-12,28774,29009,0.00816709529407913,235
شفن,2018-05-13,28840,28774,0.0022884882107389566,66
شفن,2018-05-14,28874,28840,0.0011775299577066727,34
شفن,2018-05-15,28895,28874,7.267693372304284e-4,21
شفن,2018-05-16,28951,28895,0.0019343027874016681,56
شفن,2018-05-19,29096,28951,0.004983502886823498,145
شفن,2018-05-23,30620,29096,0.04977139124592517,1524
شفن,2018-05-26,30650,30620,9.78792822154036e-4,30
شفن,2018-05-27,30777,30650,0.004126458069203416,127
شفن,2018-05-28,30534,30777,0.007958341520666852,243
شفن,2018-05-29,30013,30534,0.017359144370194278,521
شفن,2018-05-30,29978,30013,0.00116752285005112,35
شفن,2018-06-02,29980,29978,6.671114075828181e-5,2
شفن,2018-06-03,30446,29980,0.015305787295036925,466
شفن,2018-06-09,30937,30446,0.015870963570615414,491
شفن,2018-06-10,31678,30937,0.02339162825862139,741
شفن,2018-06-11,31793,31678,0.003617148428785671,115
شفن,2018-06-12,31904,31793,0.0034791875625790124,111
شفن,2018-06-13,33473,31904,0.046873599616201904,1569
شفن,2018-06-17,35146,33473,0.04760143401674155,1673
شفن,2018-06-18,36253,35146,0.030535403965726,1107
شفن,2018-06-19,36308,36253,0.0015148176709949648,55
شفن,2018-06-20,36750,36308,0.01202721088402647,442
شفن,2018-06-23,36733,36750,4.627991179467291e-4,17
شفن,2018-06-24,37945,36733,0.03194096718851124,1212
شفن,2018-06-25,39831,37945,0.04735005397686852,1886
شفن,2018-06-26,39413,39831,0.010605637733473583,418
شفن,2018-06-27,38590,39413,0.021326768592347063,823
شفن,2018-06-30,38442,38590,0.003849955777434838,148
شفن,2018-07-01,38478,38442,9.355995633625552e-4,36
شفن,2018-07-02,37899,38478,0.015277447953368758,579
شفن,2018-07-03,38788,37899,0.022919459626097777,889
شفن,2018-07-04,38270,38788,0.013535406323137303,518
شفن,2018-07-07,38273,38270,7.8384239540188e-5,3
شفن,2018-07-08,37994,38273,0.007343264725816095,279
شفن,2018-07-10,38607,37994,0.015877949594221827,613
شفن,2018-07-11,38569,38607,9.852472192438163e-4,38
شفن,2018-07-14,38467,38569,0.002651623469398403,102
شفن,2018-07-15,37997,38467,0.012369397583694255,470
شفن,2018-07-16,37090,37997,0.024454030735388137,907
شفن,2018-07-17,36930,37090,0.004332520985531207,160
شفن,2018-07-23,31669,36930,0.16612460133991838,5261
شفن,2018-07-24,32872,31669,0.0365964954965747,1203
شفن,2018-07-25,33758,32872,0.02624563066454631,886
شفن,2018-07-28,35445,33758,0.04759486528290041,1687
شفن,2018-07-29,37170,35445,0.04640839386477244,1725
شفن,2018-07-30,39028,37170,0.047606846365491264,1858
شفن,2018-07-31,42563,39028,0.08305335619944428,3535
شفن,2018-08-01,44279,42563,0.03875426274218582,1716
شفن,2018-08-04,45004,44279,0.016109679139274073,725
شفن,2018-08-05,47251,45004,0.04755454910906532,2247
شفن,2018-08-06,48006,47251,0.015727200766243236,755
شفن,2018-08-08,45881,48006,0.0463154682756192,2125
شفن,2018-08-11,43897,45881,0.04519671048032447,1984
شفن,2018-08-12,44374,43897,0.010749538017515898,477
شفن,2018-08-13,43703,44374,0.015353637049736777,671
شفن,2018-08-14,44316,43703,0.013832475854909458,613
شفن,2018-08-15,44324,44316,1.8048912552611477e-4,8
شفن,2018-08-18,44101,44324,0.00505657468073158,223
شفن,2018-08-19,44850,44101,0.016700111482347825,749
شفن,2018-08-20,45913,44850,0.023152484045408653,1063
شفن,2018-08-21,46214,45913,0.00651317782476061,301
شفن,2018-08-25,44375,46214,0.04144225352019285,1839
شفن,2018-08-26,43523,44375,0.019575856443269632,852
شفن,2018-08-27,43471,43523,0.001196199765333298,52
شفن,2018-08-28,42618,43471,0.020015017128443027,853
شفن,2018-08-29,42153,42618,0.011031243327615323,465
شفن,2018-09-01,40484,42153,0.04122616342156837,1669
شفن,2018-09-02,40017,40484,0.01167004023260939,467
شفن,2018-09-03,40179,40017,0.0040319569923583974,162
شفن,2018-09-04,42179,40179,0.04741696104584232,2000
شفن,2018-09-05,43578,42179,0.032103354903113876,1399
شفن,2018-09-08,43813,43578,0.00536370483634164,235
شفن,2018-09-09,44142,43813,0.007453219156190177,329
شفن,2018-09-10,44967,44142,0.01834678764386446,825
شفن,2018-09-11,43262,44967,0.03941103046462459,1705
شفن,2018-09-12,45167,43262,0.042176810502309724,1905
شفن,2018-09-15,47403,45167,0.04717001033590342,2236
شفن,2018-09-17,48611,47403,0.024850342514557398,1208
شفن,2018-09-18,46957,48611,0.035223715313260566,1654
شفن,2018-09-22,47298,46957,0.007209607171398165,341
شفن,2018-09-23,48330,47298,0.021353196771749364,1032
شفن,2018-09-24,48914,48330,0.011939322075235325,584
شفن,2018-09-25,51254,48914,0.045654973269488135,2340
شفن,2018-09-26,53576,51254,0.043340301626785496,2322
شفن,2018-09-29,56155,53576,0.045926453565204764,2579
شفن,2018-09-30,58725,56155,0.04376330353267325,2570
شفن,2018-10-01,56229,58725,0.044389905563954724,2496
شفن,2018-10-02,53453,56229,0.051933474266141595,2776
شفن,2018-10-03,52702,53453,0.014249933588587721,751
شفن,2018-10-06,55114,52702,0.043763834959470116,2412
شفن,2018-10-07,53093,55114,0.038065281674833494,2021
شفن,2018-10-08,54053,53093,0.0177603463264248,960
شفن,2018-10-09,56703,54053,0.04673474066545448,2650
شفن,2018-10-10,58971,56703,0.038459581827704134,2268
شفن,2018-10-13,56091,58971,0.05134513558233326,2880
شفن,2018-10-14,56067,56091,4.2805928620350545e-4,24
شفن,2018-10-15,58310,56067,0.0384668152968879,2243
شفن,2018-10-16,58458,58310,0.002531732183746763,148
شفن,2018-10-17,58179,58458,0.0047955447841180575,279
شفن,2018-10-20,60370,58179,0.036292860691795714,2191
شفن,2018-10-21,60638,60370,0.004419670833397875,268
شفن,2018-10-22,62328,60638,0.027114619432243702,1690
شفن,2018-10-23,64785,62328,0.037925445704438905,2457
شفن,2018-10-24,64418,64785,0.005697165388467553,367
شفن,2018-10-27,61932,64418,0.04014079958599527,2486
شفن,2018-10-28,61787,61932,0.0023467719746492503,145
شفن,2018-10-29,60564,61787,0.020193514298590027,1223
شفن,2018-10-31,60721,60564,0.0025855964163537227,157
شفن,2018-11-03,60206,60721,0.008553964720982063,515
شفن,2018-11-04,61203,60206,0.01629005114101776,997
شفن,2018-11-05,61758,61203,0.008986689983338406,555
شفن,2018-11-06,60904,61758,0.014022067515860664,854
شفن,2018-11-10,57892,60904,0.05202791404594714,3012
شفن,2018-11-11,57291,57892,0.0104903038869894,601
شفن,2018-11-12,58034,57291,0.012802839714429423,743
شفن,2018-11-13,58252,58034,0.0037423607772481228,218
شفن,2018-11-14,58313,58252,0.0010460789189195192,61
شفن,2018-11-17,57448,58313,0.015057095111839279,865
شفن,2018-11-18,55040,57448,0.043749999999205126,2408
شفن,2018-11-19,55328,55040,0.005205320994700598,288
شفن,2018-11-20,56032,55328,0.012564249000346868,704
شفن,2018-11-21,55790,56032,0.004337694927328595,242
شفن,2018-11-24,55362,55790,0.00773093457592336,428
شفن,2018-11-26,52856,55362,0.04741183593069071,2506
شفن,2018-11-27,53374,52856,0.009705099861173884,518
شفن,2018-11-28,52404,53374,0.018510037401371842,970
شفن,2018-12-01,52277,52404,0.002429366643027921,127
شفن,2018-12-02,50345,52277,0.038375211043035554,1932
شفن,2018-12-03,50092,50345,0.005050706699571774,253
شفن,2018-12-04,49633,50092,0.009247879434866966,459
شفن,2018-12-05,48239,49633,0.028897779804123266,1394
شفن,2018-12-08,48137,48239,0.0021189521573401135,102
شفن,2018-12-09,48172,48137,7.265631487020144e-4,35
شفن,2018-12-10,48124,48172,9.97423323061312e-4,48
شفن,2018-12-11,47762,48124,0.007579247100046496,362
شفن,2018-12-12,46296,47762,0.031665802660453046,1466
شفن,2018-12-15,46222,46296,0.00160096923539438,74
شفن,2018-12-16,46184,46222,8.227957734102114e-4,38
شفن,2018-12-17,45996,46184,0.004087311940079848,188
شفن,2018-12-18,45243,45996,0.01664345865621989,753
شفن,2018-12-19,43928,45243,0.029935348751822632,1315
شفن,2018-12-22,43595,43928,0.00763849065242256,333
شفن,2018-12-23,43548,43595,0.0010792688527353892,47
شفن,2018-12-24,42700,43548,0.01985948477705247,848
شفن,2018-12-25,41895,42700,0.0192147034247711,805
شفن,2018-12-26,42213,41895,0.007533224361984857,318
شفن,2018-12-29,43233,42213,0.023593088612319454,1020
شفن,2018-12-30,43427,43233,0.0044672669075812915,194
شفن,2018-12-31,43878,43427,0.010278499475585066,451
شفن,2019-01-01,43955,43878,0.0017517916050107658,77
شفن,2019-01-02,44240,43955,0.006442133815405919,285
شفن,2019-01-05,44238,44240,4.5210000451078034e-5,2
شفن,2019-01-06,44243,44238,1.1301222792050693e-4,5
شفن,2019-01-07,44416,44243,0.0038949927953013555,173
شفن,2019-01-08,44644,44416,0.005107069258912573,228
شفن,2019-01-09,44687,44644,9.62248528633333e-4,43
شفن,2019-01-12,44758,44687,0.001586308592841809,71
شفن,2019-01-13,44712,44758,0.0010288065843391302,46
شفن,2019-01-14,44797,44712,0.0018974484898118748,85
شفن,2019-01-15,44859,44797,0.0013821083840169842,62
شفن,2019-01-16,45067,44859,0.004615350478074526,208
شفن,2019-01-19,45083,45067,3.5490096044285205e-4,16
شفن,2019-01-20,45440,45083,0.007856514084334144,357
شفن,2019-01-21,45676,45440,0.005166827217681784,236
شفن,2019-01-22,45889,45676,0.004641635250176695,213
شفن,2019-01-23,45988,45889,0.0021527354961695935,99
شفن,2019-01-26,46090,45988,0.002213061401557538,102
شفن,2019-01-27,45024,46090,0.02367626154887002,1066
شفن,2019-01-28,44911,45024,0.0025160873727479664,113
شفن,2019-01-29,44812,44911,0.00220922967057464,99
شفن,2019-01-30,44870,44812,0.0012926231334679603,58
شفن,2019-02-02,45110,44870,0.005320328086780751,240
شفن,2019-02-03,45492,45110,0.008397080805231754,382
شفن,2019-02-04,45509,45492,3.735524841158111e-4,17
شفن,2019-02-05,45503,45509,1.3185943783636554e-4,6
شفن,2019-02-06,45499,45503,8.791402008642138e-5,4
شفن,2019-02-10,45741,45499,0.005290658271456884,242
شفن,2019-02-12,46264,45741,0.01130468614881323,523
شفن,2019-02-13,46439,46264,0.003768384332053481,175
شفن,2019-02-16,46422,46439,3.6620567833427675e-4,17
شفن,2019-02-17,46590,46422,0.003605924017952223,168
شفن,2019-02-18,46757,46590,0.0035716577196233364,167
شفن,2019-02-19,46735,46757,4.7073927462349974e-4,22
شفن,2019-02-20,46860,46735,0.002667520273097151,125
شفن,2019-02-23,47186,46860,0.00690882888977856,326
شفن,2019-02-24,49533,47186,0.047382553044487866,2347
شفن,2019-02-25,49654,49533,0.0024368630925517207,121
شفن,2019-02-26,48993,49654,0.013491723307135882,661
شفن,2019-02-27,48331,48993,0.013697212968618543,662
شفن,2019-03-02,47937,48331,0.008219120929381915,394
شفن,2019-03-03,47892,47937,9.396141317769228e-4,45
شفن,2019-03-04,47729,47892,0.003415114500546521,163
شفن,2019-03-05,47485,47729,0.005138464778242846,244
شفن,2019-03-06,47218,47485,0.005654623236781426,267
شفن,2019-03-09,47423,47218,0.004322796954972844,205
شفن,2019-03-10,48214,47423,0.01640602314646356,791
شفن,2019-03-11,48456,48214,0.004994221561726221,242
شفن,2019-03-12,49262,48456,0.01636149567584829,806
شفن,2019-03-13,49909,49262,0.012963593740348162,647
شفن,2019-03-16,51120,49909,0.023689358371993558,1211
شفن,2019-03-17,53554,51120,0.04544945288782445,2434
شفن,2019-03-18,54812,53554,0.022951178573616157,1258
شفن,2019-03-19,54731,54812,0.0014799656501529304,81
شفن,2019-03-25,54736,54731,9.134755919154947e-5,5
شفن,2019-03-26,54723,54736,2.3756007528392888e-4,13
شفن,2019-03-27,54648,54723,0.0013724198506556064,75
شفن,2019-03-30,55318,54648,0.012111790013881345,670
شفن,2019-03-31,55684,55318,0.006572803677778665,366
شفن,2019-04-06,55796,55684,0.0020073123521039626,112
شفن,2019-04-07,55934,55796,0.0024671934779835663,138
شفن,2019-04-08,56934,55934,0.017564197140240205,1000
شفن,2019-04-09,56904,56934,5.272037115048643e-4,30
شفن,2019-04-10,56967,56904,0.0011059034177487686,63
شفن,2019-04-13,57075,56967,0.001892247043330841,108
شفن,2019-04-14,57066,57075,1.5771212280240928e-4,9
شفن,2019-04-15,57375,57066,0.005385620914938813,309
شفن,2019-04-16,57384,57375,1.5683814303365333e-4,9
شفن,2019-04-17,57327,57384,9.942958815044518e-4,57
شفن,2019-04-20,57370,57327,7.49520655381741e-4,43
شفن,2019-04-22,57269,57370,0.001763606837874529,101
شفن,2019-04-23,57048,57269,0.0038739307249355992,221
شفن,2019-04-24,56991,57048,0.0010001579196539778,57
شفن,2019-04-27,56995,56991,7.018159487551221e-5,4
شفن,2019-04-28,56948,56995,8.253143218229734e-4,47
شفن,2019-04-29,56716,56948,0.004090556456659663,232
شفن,2019-04-30,56331,56716,0.006834602616555101,385
شفن,2019-05-01,56613,56331,0.0049811880662571995,282
شفن,2019-05-04,56852,56613,0.004203897839931684,239
شفن,2019-05-05,57422,56852,0.009926509003344946,570
شفن,2019-05-06,57343,57422,0.0013776746943588987,79
شفن,2019-05-07,55093,57343,0.040840034123376105,2250
شفن,2019-05-08,55715,55093,0.011163959436217105,622
شفن,2019-05-11,55879,55715,0.0029349129368289534,164
شفن,2019-05-12,55471,55879,0.0073551946060580265,408
شفن,2019-05-13,55913,55471,0.007905138339779566,442
شفن,2019-05-14,56007,55913,0.0016783616333372906,94
شفن,2019-05-15,56131,56007,0.0022091179561702246,124
شفن,2019-05-18,56155,56131,4.273884783113278e-4,24
شفن,2019-05-19,58470,56155,0.03959295365076804,2315
شفن,2019-05-20,61391,58470,0.04758026420733364,2921
شفن,2019-05-21,64112,61391,0.04244135263223045,2721
شفن,2019-05-22,65201,64112,0.01670219781879569,1089
شفن,2019-05-25,63192,65201,0.03179199898671047,2009
شفن,2019-05-26,64031,63192,0.01310302822050096,839
شفن,2019-05-28,65151,64031,0.017190833601676246,1120
شفن,2019-05-29,64473,65151,0.010516029965869185,678
شفن,2019-06-01,64219,64473,0.00395521574605716,254
شفن,2019-06-02,66216,64219,0.0301588739877045,1997
شفن,2019-06-03,67733,66216,0.022396763763270537,1517
شفن,2019-06-08,66518,67733,0.01826573258338697,1215
شفن,2019-06-09,65928,66518,0.008949156655609922,590
شفن,2019-06-10,65258,65928,0.010266940451588052,670
شفن,2019-06-11,65285,65258,4.135712644495126e-4,27
شفن,2019-06-12,65709,65285,0.0064526929338986645,424
شفن,2019-06-16,66933,65709,0.018286943659804777,1224
شفن,2019-06-17,66857,66933,0.0011367545656978814,76
شفن,2019-06-18,66338,66857,0.007823570200973446,519
شفن,2019-06-19,66464,66338,0.0018957631198559257,126
شفن,2019-06-22,66250,66464,0.003230188679196526,214
شفن,2019-06-23,66422,66250,0.0025895034777244064,172
شفن,2019-06-24,66741,66422,0.004779670667134451,319
شفن,2019-06-25,68933,66741,0.03179899322484443,2192
شفن,2019-06-26,72089,68933,0.043779217355716146,3156
شفن,2019-06-30,74309,72089,0.029875250642185,2220
شفن,2019-07-03,74851,74309,0.007241052223654447,542
شفن,2019-07-06,74175,74851,0.0091135827433891,676
شفن,2019-07-07,74004,74175,0.002310685908838567,171
شفن,2019-07-08,72972,74004,0.014142410787505586,1032
شفن,2019-07-09,73413,72972,0.006007110457194134,441
شفن,2019-07-16,54609,73413,0.3443388452389837,18804
شفن,2019-07-17,57313,54609,0.047179522969532574,2704
شفن,2019-07-20,60178,57313,0.04760876067586811,2865
شفن,2019-07-21,63186,60178,0.0476054822263222,3008
شفن,2019-07-22,66345,63186,0.047614741125214945,3159
شفن,2019-07-23,68203,66345,0.02724220342173743,1858
شفن,2019-07-24,70499,68203,0.032567837841209556,2296
شفن,2019-07-27,69011,70499,0.021561780005773547,1488
شفن,2019-07-28,67723,69011,0.01901864949841238,1288
شفن,2019-07-29,66612,67723,0.016678676514491706,1111
شفن,2019-07-30,66918,66612,0.004572760692122109,306
شفن,2019-07-31,66789,66918,0.0019314557786172656,129
شفن,2019-08-03,65690,66789,0.016730095904753692,1099
شفن,2019-08-04,63949,65690,0.027224819777835075,1741
شفن,2019-08-05,64092,63949,0.0022311676964015606,143
شفن,2019-08-06,63951,64092,0.0022048130599645853,141
شفن,2019-08-07,63949,63951,3.1274922203141955e-5,2
شفن,2019-08-10,64175,63949,0.003521620568702429,226
شفن,2019-08-11,64437,64175,0.0040659869329101915,262
شفن,2019-08-13,64002,64437,0.006796662604187422,435
شفن,2019-08-14,64926,64002,0.014231586729288242,924
شفن,2019-08-17,64728,64926,0.003058954393723598,198
شفن,2019-08-18,64192,64728,0.008349950149421269,536
شفن,2019-08-19,64084,64192,0.0016852880593957104,108
شفن,2019-08-21,64234,64084,0.0023352118815216987,150
شفن,2019-08-24,64660,64234,0.0065883080728953245,426
شفن,2019-08-25,67062,64660,0.0358176016218452,2402
شفن,2019-08-26,68853,67062,0.02601193847724846,1791
شفن,2019-08-27,71603,68853,0.038406212029685825,2750
شفن,2019-08-28,69441,71603,0.031134344263027115,2162
شفن,2019-08-31,69314,69441,0.0018322416827504945,127
شفن,2019-09-01,69720,69314,0.0058232931726072395,406
شفن,2019-09-02,69517,69720,0.0029201490282532313,203
شفن,2019-09-03,69691,69517,0.0024967355899255753,174
شفن,2019-09-04,70117,69691,0.006075559422022113,426
شفن,2019-09-07,70974,70117,0.012074844309013516,857
شفن,2019-09-08,70471,70974,0.007137687843125007,503
شفن,2019-09-11,69926,70471,0.007793953607988532,545
شفن,2019-09-14,69933,69926,1.000958059842979e-4,7
شفن,2019-09-15,69777,69933,0.002235693709929695,156
شفن,2019-09-16,69756,69777,3.010493720927082e-4,21
شفن,2019-09-17,69505,69756,0.0036112509890855156,251
شفن,2019-09-18,68102,69505,0.02060145076472642,1403
شفن,2019-09-21,69688,68102,0.022758581104024244,1586
شفن,2019-09-22,72894,69688,0.04398167201629789,3206
شفن,2019-09-23,76402,72894,0.045915028401796884,3508
شفن,2019-09-24,76802,76402,0.005208197703117,400
شفن,2019-09-25,76933,76802,0.0017027803413138345,131
شفن,2019-09-28,75947,76933,0.012982737961828873,986
شفن,2019-09-29,73044,75947,0.03974316850063328,2903
شفن,2019-09-30,72413,73044,0.008713904961695914,631
شفن,2019-10-01,71843,72413,0.007933967122643349,570
شفن,2019-10-02,70888,71843,0.013471955761010724,955
شفن,2019-10-05,70473,70888,0.00588878010009665,415
شفن,2019-10-06,69552,70473,0.013241890959091876,921
شفن,2019-10-07,70094,69552,0.007732473535427677,542
شفن,2019-10-08,70129,70094,4.990802663591514e-4,35
شفن,2019-10-09,70592,70129,0.006558816863007724,463
شفن,2019-10-12,73841,70592,0.04399994582895682,3249
شفن,2019-10-13,75364,73841,0.020208587654314946,1523
شفن,2019-10-14,73973,75364,0.018804158273710625,1391
شفن,2019-10-15,73197,73973,0.010601527384857283,776
شفن,2019-10-16,73814,73197,0.008358847914916428,617
شفن,2019-10-20,72755,73814,0.014555700638931269,1059
شفن,2019-10-21,72772,72755,2.3360633210254487e-4,17
شفن,2019-10-22,74965,72772,0.029253651703738365,2193
شفن,2019-10-23,76337,74965,0.017972935797608332,1372
شفن,2019-10-26,76380,76337,5.629746006734358e-4,43
شفن,2019-10-28,76752,76380,0.004846779236959991,372
شفن,2019-10-30,76390,76752,0.004738840162262877,362
شفن,2019-11-02,75940,76390,0.005925730840058919,450
شفن,2019-11-03,75357,75940,0.007736507557257634,583
شفن,2019-11-04,73935,75357,0.019233110164073402,1422
شفن,2019-11-05,73970,73935,4.7316479653274085e-4,35
شفن,2019-11-09,75157,73970,0.015793605385848376,1187
شفن,2019-11-10,75869,75157,0.009384597134410833,712
شفن,2019-11-11,76346,75869,0.0062478715321529895,477
شفن,2019-11-12,76179,76346,0.00219220520087961,167
شفن,2019-11-13,76718,76179,0.007025730597682087,539
شفن,2019-11-16,77291,76718,0.007413541033142106,573
شفن,2019-11-17,77166,77291,0.0016198844050278637,125
شفن,2019-11-18,76954,77166,0.002754892533165854,212
شفن,2019-11-19,76861,76954,0.0012099764509802115,93
شفن,2019-11-20,76137,76861,0.009509174251553001,724
شفن,2019-11-23,75980,76137,0.0020663332455637495,157
شفن,2019-11-24,75324,75980,0.008709043598206295,656
شفن,2019-11-25,74829,75324,0.0066150823877558825,495
شفن,2019-11-26,74884,74829,7.344693125269154e-4,55
شفن,2019-11-27,74233,74884,0.008769684641483307,651
شفن,2019-11-30,72653,74233,0.02174720933723663,1580
شفن,2019-12-01,71634,72653,0.014225088644858238,1019
شفن,2019-12-02,71683,71634,6.835651409583366e-4,49
شفن,2019-12-03,73511,71683,0.02486702670314828,1828
شفن,2019-12-04,73167,73511,0.004701573113497867,344
شفن,2019-12-07,73977,73167,0.010949349121876404,810
شفن,2019-12-08,74064,73977,0.0011746597537106468,87
شفن,2019-12-09,74397,74064,0.004475986934896891,333
شفن,2019-12-10,75018,74397,0.008278013276703218,621
شفن,2019-12-11,75350,75018,0.004406104844002574,332
شفن,2019-12-14,77568,75350,0.028594265676199025,2218
شفن,2019-12-15,78972,77568,0.01777845312240062,1404
شفن,2019-12-16,78694,78972,0.0035326708516083484,278
شفن,2019-12-17,78105,78694,0.00754113052931898,589
شفن,2019-12-18,78388,78105,0.003610246466249806,283
شفن,2019-12-21,81419,78388,0.037227182843842015,3031
شفن,2019-12-22,81707,81419,0.0035247897976486134,288
شفن,2019-12-23,81245,81707,0.0056865037847783064,462
شفن,2019-12-24,81434,81245,0.002320897905023444,189
شفن,2019-12-25,80942,81434,0.006078426527561978,492
شفن,2019-12-28,83244,80942,0.02765364470679384,2302
شفن,2019-12-29,84030,83244,0.009353802213383866,786
شفن,2019-12-30,85261,84030,0.014438019727490436,1231
شفن,2019-12-31,86345,85261,0.012554288030429623,1084
شفن,2020-01-01,90217,86345,0.04291874036996444,3872
شفن,2020-01-04,87220,90217,0.03436138500304562,2997
شفن,2020-01-05,89928,87220,0.03011297927197188,2708
شفن,2020-01-07,91304,89928,0.015070533601867712,1376
شفن,2020-01-08,89478,91304,0.020407250944138144,1826
شفن,2020-01-11,91267,89478,0.019601827604505444,1789
شفن,2020-01-12,95615,91267,0.045474036500073485,4348
شفن,2020-01-13,96147,95615,0.0055331939633526455,532
شفن,2020-01-14,96651,96147,0.00521463823441853,504
شفن,2020-01-15,96707,96651,5.79068733384563e-4,56
شفن,2020-01-18,97288,96707,0.005971959542739372,581
شفن,2020-01-19,96097,97288,0.012393727171374823,1191
شفن,2020-01-20,91507,96097,0.05016009704120822,4590
شفن,2020-01-21,91105,91507,0.004412491081670463,402
شفن,2020-01-22,92123,91105,0.011050443428774027,1018
شفن,2020-01-25,93777,92123,0.017637587041410607,1654
شفن,2020-01-26,92066,93777,0.018584493732555076,1711
شفن,2020-01-27,91765,92066,0.0032801176918947302,301
شفن,2020-01-28,92402,91765,0.0068937901776271755,637
شفن,2020-02-01,90905,92402,0.016467741048166024,1497
شفن,2020-02-02,91132,90905,0.0024908923319745986,227
شفن,2020-02-03,91608,91132,0.005196052746428303,476
شفن,2020-02-04,91648,91608,4.364525139617182e-4,40
شفن,2020-02-05,91299,91648,0.003822604847765884,349
شفن,2020-02-08,92599,91299,0.014039028499076244,1300
شفن,2020-02-09,92068,92599,0.005767476213171053,531
شفن,2020-02-10,91138,92068,0.010204305558491472,930
شفن,2020-02-12,92980,91138,0.019810711980858136,1842
شفن,2020-02-15,94196,92980,0.012909253046701461,1216
شفن,2020-02-16,98647,94196,0.04512048009523736,4451
شفن,2020-02-17,100215,98647,0.015646360325144475,1568
شفن,2020-02-18,100372,100215,0.0015641812457501676,157
شفن,2020-02-19,101526,100372,0.01136654650029188,1154
شفن,2020-02-22,101635,101526,0.0010724651940662916,109
شفن,2020-02-23,106432,101635,0.045071031268367874,4797
شفن,2020-02-24,109880,106432,0.03137968693091209,3448
شفن,2020-02-25,112865,109880,0.026447525804931135,2985
شفن,2020-02-26,109701,112865,0.028842034256489534,3164
شفن,2020-02-29,104681,109701,0.04795521632342111,5020
شفن,2020-03-01,105100,104681,0.003986679352959214,419
شفن,2020-03-02,106404,105100,0.012255178376637579,1304
شفن,2020-03-03,109290,106404,0.026406807575931862,2886
شفن,2020-03-04,112578,109290,0.029206416884034126,3288
شفن,2020-03-07,111010,112578,0.01412485361666404,1568
شفن,2020-03-09,110139,111010,0.007908188743243463,871
شفن,2020-03-10,108000,110139,0.01980555555537217,2139
شفن,2020-03-11,102731,108000,0.05128928950315592,5269
شفن,2020-03-14,98736,102731,0.04046143250647726,3995
شفن,2020-03-15,97036,98736,0.017519271198137606,1700
شفن,2020-03-16,100634,97036,0.03575332392595194,3598
شفن,2020-03-17,99782,100634,0.008538614178824452,852
شفن,2020-03-18,100913,99782,0.011207673936844534,1131
شفن,2020-04-12,105958,100913,0.047613205231812485,5045
شفن,2020-04-13,111255,105958,0.04761134330998507,5297
شفن,2020-04-14,116779,111255,0.047303025372307496,5524
شفن,2020-04-15,118657,116779,0.01582713198533734,1878
شفن,2020-04-18,120422,118657,0.014656790287367286,1765
شفن,2020-04-19,126443,120422,0.047618294408962,6021
شفن,2020-04-20,131751,126443,0.040288119254956026,5308
شفن,2020-04-21,137940,131751,0.04486733362298922,6189
شفن,2020-04-22,144833,137940,0.04759274474707012,6893
شفن,2020-04-25,151989,144833,0.04708235464377631,7156
شفن,2020-04-26,152909,151989,0.0060166504260310595,920
شفن,2020-04-27,157914,152909,0.0316944666082064,5005
شفن,2020-04-28,159160,157914,0.007828600150742469,1246
شفن,2020-05-03,162742,159160,0.022010298509161676,3582
شفن,2020-05-04,169767,162742,0.041380244688064345,7025
شفن,2020-05-05,166663,169767,0.018624409736902464,3104
شفن,2020-05-06,160415,166663,0.03894897609301531,6248
شفن,2020-05-09,168127,160415,0.04587008630353322,7712
شفن,2020-05-10,176533,168127,0.04761715939768985,8406
شفن,2020-05-11,182365,176533,0.031979820689101636,5832
شفن,2020-05-12,173874,182365,0.0488342132806007,8491
شفن,2020-05-13,174341,173874,0.002678658491102617,467
شفن,2020-05-16,166165,174341,0.049204104353809744,8176
شفن,2020-05-17,167137,166165,0.005815588409473571,972
شفن,2020-05-18,175020,167137,0.045040566792109236,7883
شفن,2020-05-19,183623,175020,0.04685142928692565,8603
شفن,2020-05-20,180182,183623,0.01909735711658713,3441
شفن,2020-05-23,183101,180182,0.01594202107025116,2919
شفن,2020-05-26,174259,183101,0.05074056433211059,8842
شفن,2020-05-27,179835,174259,0.031006200127722598,5576
شفن,2020-05-30,188443,179835,0.045679595421184764,8608
شفن,2020-05-31,190940,188443,0.013077406515067155,2497
شفن,2020-06-01,190511,190940,0.0022518384765065963,429
شفن,2020-06-02,193151,190511,0.013668062810890608,2640
شفن,2020-06-06,196530,193151,0.017193303821212064,3379
شفن,2020-06-07,203321,196530,0.03340038658066112,6791
شفن,2020-06-08,201680,203321,0.008136652122133397,1641
شفن,2020-06-09,211162,201680,0.04490391263558356,9482
شفن,2020-06-10,216077,211162,0.022746520916049617,4915
شفن,2020-06-13,220830,216077,0.021523343748487418,4753
شفن,2020-06-14,231580,220830,0.046420243544147075,10750
شفن,2020-06-15,232920,231580,0.005753048256887544,1340
شفن,2020-06-16,234530,232920,0.006864793416591204,1610
شفن,2020-06-20,244220,234530,0.039677340103023186,9690
شفن,2020-06-21,254950,244220,0.042086683663298347,10730
شفن,2020-06-22,267690,254950,0.047592364301813316,12740
شفن,2020-06-23,279560,267690,0.042459579338809346,11870
شفن,2020-06-24,293500,279560,0.04749574105605623,13940
شفن,2020-06-27,301900,293500,0.027823782709414296,8400
شفن,2020-06-28,301950,301900,1.6559032952420734e-4,50
شفن,2020-06-29,288890,301950,0.04520751843246493,13060
شفن,2020-06-30,300380,288890,0.038251548039023066,11490
شفن,2020-07-01,314450,300380,0.04474479249468995,14070
شفن,2020-07-07,314620,314450,5.403343716211928e-4,170
شفن,2020-07-08,303910,314620,0.03524069625864486,10710
شفن,2020-07-11,292540,303910,0.03886647979750165,11370
شفن,2020-07-12,307160,292540,0.047597343403934116,14620
شفن,2020-07-13,322510,307160,0.047595423397576525,15350
شفن,2020-07-14,338630,322510,0.04760357912752088,16120
شفن,2020-07-15,355560,338630,0.047615029811993434,16930
شفن,2020-07-18,369090,355560,0.0366577257578459,13530
شفن,2020-07-19,386490,369090,0.04502056974295578,17400
شفن,2020-07-20,405800,386490,0.047585017249759526,19310
شفن,2020-07-21,421370,405800,0.0369508982603485,15570
شفن,2020-07-22,427820,421370,0.015076434014269842,6450
شفن,2020-07-25,444850,427820,0.03828256715738275,17030
شفن,2020-07-26,425140,444850,0.046361198663860466,19710
شفن,2020-07-27,406220,425140,0.04657574713198125,18920
شفن,2020-07-28,402900,406220,0.00824025812854743,3320
شفن,2020-07-29,382800,402900,0.05250783699045844,20100
شفن,2020-08-01,366030,382800,0.045815916728011864,16770
شفن,2020-08-02,357630,366030,0.02348796241919445,8400
شفن,2020-08-03,362830,357630,0.014331780723715427,5200
شفن,2020-08-04,360740,362830,0.005793646393508362,2090
شفن,2020-08-05,361540,360740,0.0022127565414554054,800
شفن,2020-08-09,346380,361540,0.043766961140817115,15160
شفن,2020-08-10,331940,346380,0.04350183768137765,14440
شفن,2020-08-11,315390,331940,0.05247471384618258,16550
شفن,2020-08-12,306620,315390,0.02860217859230121,8770
شفن,2020-08-15,291320,306620,0.052519566112685295,15300
شفن,2020-08-16,285950,291320,0.018779506906736215,5370
شفن,2020-08-17,300190,285950,0.047436623471643166,14240
شفن,2020-08-18,313870,300190,0.043584923694384346,13680
شفن,2020-08-19,298710,313870,0.05075156506293478,15160
شفن,2020-08-22,288290,298710,0.036144160393922285,10420
شفن,2020-08-23,275110,288290,0.04790810948330519,13180
شفن,2020-08-24,261760,275110,0.051000916870220805,13350
شفن,2020-08-25,274820,261760,0.047522014409258705,13060
شفن,2020-08-26,286640,274820,0.041236394083026665,11820
شفن,2020-08-31,281740,286640,0.017391921629809782,4900
شفن,2020-09-01,267660,281740,0.05260404991387355,14080
شفن,2020-09-02,254710,267660,0.050842134191626386,12950
شفن,2020-09-05,257080,254710,0.009218920180452703,2370
شفن,2020-09-06,250780,257080,0.025121620543802847,6300
شفن,2020-09-07,238700,250780,0.05060745705885795,12080
شفن,2020-09-08,234840,238700,0.016436722875079045,3860
شفن,2020-09-09,242320,234840,0.030868273357416355,7480
بفجر,2018-01-15,5886,5906,0.003397893305572903,20
بفجر,2018-01-16,5879,5886,0.0011906786866489746,7
بفجر,2018-01-17,5725,5879,0.026899563314078678,154
بفجر,2018-01-20,5723,5725,3.494670626682741e-4,2
بفجر,2018-01-21,5701,5723,0.0038589721094792187,22
بفجر,2018-01-22,5702,5701,1.7537706064970588e-4,1
بفجر,2018-01-23,5701,5702,1.754078231581463e-4,1
بفجر,2018-01-24,5699,5701,3.50938761124594e-4,2
بفجر,2018-01-27,5699,5699,0,0
بفجر,2018-01-28,5698,5699,1.7550017546937518e-4,1
بفجر,2018-01-29,5667,5698,0.005470266453949132,31
بفجر,2018-01-30,5660,5667,0.0012367491163892668,7
بفجر,2018-01-31,5638,5660,0.0039020929400670284,22
بفجر,2018-02-03,5636,5638,3.5486160391148656e-4,2
بفجر,2018-02-04,5634,5636,3.549875753718517e-4,2
بفجر,2018-02-05,5629,5634,8.882572391387e-4,5
بفجر,2018-02-06,5513,5629,0.02104117539977486,116
بفجر,2018-02-07,5480,5513,0.006021897809120091,33
بفجر,2018-02-10,5479,5480,1.8251505745893134e-4,1
بفجر,2018-02-12,5421,5479,0.010699132999317629,58
بفجر,2018-02-13,5245,5421,0.03355576739112378,176
بفجر,2018-02-18,5279,5245,0.0064406137513846155,34
بفجر,2018-02-19,5326,5279,0.008824633869916516,47
بفجر,2018-02-21,5399,5326,0.013521022409053339,73
بفجر,2018-02-24,5505,5399,0.01925522252147952,106
بفجر,2018-02-25,5542,5505,0.006676290146756353,37
بفجر,2018-02-26,5549,5542,0.0012614885562693297,7
بفجر,2018-02-27,5549,5549,0,0
بفجر,2018-02-28,5537,5549,0.0021672385764552574,12
بفجر,2018-03-03,5495,5537,0.0076433121005198695,42
بفجر,2018-03-04,5486,5495,0.001640539554932457,9
بفجر,2018-03-05,5449,5486,0.006790236739440221,37
بفجر,2018-03-06,5446,5449,5.508630186281926e-4,3
بفجر,2018-03-07,5433,5446,0.0023927848329849464,13
بفجر,2018-03-10,5265,5433,0.03190883190277135,168
بفجر,2018-03-11,5264,5265,1.8996960482713343e-4,1
بفجر,2018-03-12,5260,5264,7.60456273619685e-4,4
بفجر,2018-03-13,5256,5260,7.610350074655565e-4,4
بفجر,2018-03-14,5255,5256,1.9029495714742244e-4,1
بفجر,2018-03-17,5289,5255,0.006428436376171594,34
بفجر,2018-03-18,5288,5289,1.891074129748284e-4,1
بفجر,2018-03-19,5288,5288,0,0
بفجر,2018-03-25,5288,5288,0,0
بفجر,2018-03-26,5312,5288,0.004518072288306085,24
بفجر,2018-03-27,5312,5312,0,0
بفجر,2018-03-28,5314,5312,3.7636432059157614e-4,2
بفجر,2018-04-03,5313,5314,1.8821757948650147e-4,1
بفجر,2018-04-04,5311,5313,3.765769157641542e-4,2
بفجر,2018-04-07,5289,5311,0.004159576478699267,22
بفجر,2018-04-08,5238,5289,0.009736540662516887,51
بفجر,2018-04-09,5219,5238,0.0036405441648514,19
بفجر,2018-04-10,5266,5219,0.008925180400887736,47
بفجر,2018-04-11,5429,5266,0.030023945472458288,163
بفجر,2018-04-15,5428,5429,1.84229918904895e-4,1
بفجر,2018-04-16,5422,5428,0.0011066027294159713,6
بفجر,2018-04-17,5422,5422,0,0
بفجر,2018-04-18,5415,5422,0.0012927054475913747,7
بفجر,2018-04-21,5411,5415,7.392348917502799e-4,4
بفجر,2018-04-22,5409,5411,3.6975411344615375e-4,2
بفجر,2018-04-23,5402,5409,0.0012958163640696377,7
بفجر,2018-04-24,5397,5402,9.2644061498491e-4,5
بفجر,2018-04-25,5377,5397,0.0037195462146699743,20
بفجر,2018-04-28,5367,5377,0.0018632383078324504,10
بفجر,2018-04-29,5359,5367,0.0014928158235691703,8
بفجر,2018-04-30,5354,5359,9.338812101356217e-4,5
بفجر,2018-05-01,5351,5354,5.606428703867234e-4,3
بفجر,2018-05-05,5256,5351,0.018074581427306967,95
بفجر,2018-05-06,5255,5256,1.9029495714742244e-4,1
بفجر,2018-05-07,5255,5255,0,0
بفجر,2018-05-08,5255,5255,0,0
بفجر,2018-05-09,5291,5255,0.006804006802720845,36
بفجر,2018-05-12,5291,5291,0,0
بفجر,2018-05-13,5290,5291,1.89035916788462e-4,1
بفجر,2018-05-14,5287,5290,5.674295440576074e-4,3
بفجر,2018-05-15,5280,5287,0.0013257575755064852,7
بفجر,2018-05-16,5255,5280,0.004757373928685561,25
بفجر,2018-05-19,5257,5255,3.8044512071895657e-4,2
بفجر,2018-05-20,5316,5257,0.011098570351561593,59
بفجر,2018-05-21,5316,5316,0,0
بفجر,2018-05-22,5430,5316,0.02099447513425516,114
بفجر,2018-05-23,5416,5430,0.0025849335298033724,14
بفجر,2018-05-26,5405,5416,0.002035152636071202,11
بفجر,2018-05-27,5496,5405,0.016557496357977163,91
بفجر,2018-05-28,5493,5496,5.461496449033043e-4,3
بفجر,2018-05-29,5479,5493,0.0025552108044250388,14
بفجر,2018-05-30,5468,5479,0.002011704461958357,11
بفجر,2018-06-02,5456,5468,0.002199413489332952,12
بفجر,2018-06-03,5452,5456,7.336757151992524e-4,4
بفجر,2018-06-09,5384,5452,0.012630014856495167,68
بفجر,2018-06-10,5370,5384,0.0026070763496076205,14
بفجر,2018-06-11,5370,5370,0,0
بفجر,2018-06-12,5366,5370,7.454342152915702e-4,4
بفجر,2018-06-13,5406,5366,0.007399186088161452,40
بفجر,2018-06-17,5430,5406,0.004419889501948455,24
بفجر,2018-06-18,5414,5430,0.0029553010707507755,16
بفجر,2018-06-19,5433,5414,0.0034971470635933835,19
بفجر,2018-06-20,5426,5433,0.0012900847767618716,7
بفجر,2018-06-23,5414,5426,0.0022164758030630816,12
بفجر,2018-06-24,5394,5414,0.0037078235069136403,20
بفجر,2018-07-01,4696,5394,0.14863713795812666,698
بفجر,2018-07-02,4499,4696,0.043787508325452876,197
بفجر,2018-07-03,4498,4499,2.2232103152015982e-4,1
بفجر,2018-07-04,4549,4498,0.011211255218463122,51
بفجر,2018-07-07,4542,4549,0.0015411712898412216,7
بفجر,2018-07-08,4450,4542,0.020674157298724908,92
بفجر,2018-07-10,4448,4450,4.4964028766869595e-4,2
بفجر,2018-07-11,4390,4448,0.013211845099496161,58
بفجر,2018-07-14,4389,4390,2.2784233305357885e-4,1
بفجر,2018-07-15,4314,4389,0.017385257297778102,75
بفجر,2018-07-16,4318,4314,9.26354793671525e-4,4
بفجر,2018-07-17,4352,4318,0.0078124999982048474,34
بفجر,2018-07-18,4438,4352,0.01937809823808515,86
بفجر,2018-07-21,4437,4438,2.2537750727397396e-4,1
بفجر,2018-07-22,4430,4437,0.001580135439823897,7
بفجر,2018-07-23,4427,4430,6.776598146199097e-4,3
بفجر,2018-07-24,4431,4427,9.02730760346935e-4,4
بفجر,2018-07-25,4427,4431,9.035464194932128e-4,4
بفجر,2018-07-28,4364,4427,0.01443629697194402,63
بفجر,2018-07-29,4351,4364,0.0029878188915219905,13
بفجر,2018-07-30,4331,4351,0.00461787116032836,20
بفجر,2018-07-31,4501,4331,0.03776938457281284,170
بفجر,2018-08-01,4706,4501,0.04356141095546931,205
بفجر,2018-08-04,5110,4706,0.07906066534656346,404
بفجر,2018-08-05,5365,5110,0.047530288900739924,255
بفجر,2018-08-06,5633,5365,0.0475767796826599,268
بفجر,2018-08-07,5871,5633,0.04053823879398088,238
بفجر,2018-08-08,5802,5871,0.011892450876957523,69
بفجر,2018-08-11,5601,5802,0.03588644884201277,201
بفجر,2018-08-12,5569,5601,0.005746094450395745,32
بفجر,2018-08-13,5501,5569,0.012361388836145902,68
بفجر,2018-08-14,5445,5501,0.010284664828230547,56
بفجر,2018-08-15,5358,5445,0.016237402012646993,87
بفجر,2018-08-18,5537,5358,0.032327975432124255,179
بفجر,2018-08-19,5794,5537,0.04435623057570655,257
بفجر,2018-08-20,5860,5794,0.011262798632890307,66
بفجر,2018-08-21,5927,5860,0.01130420111164093,67
بفجر,2018-08-25,6037,5927,0.018220970677783506,110
بفجر,2018-08-26,6104,6037,0.010976408910390496,67
بفجر,2018-08-27,6252,6104,0.023672424820269926,148
بفجر,2018-08-28,5952,6252,0.05040322579798333,300
بفجر,2018-08-29,5855,5952,0.01656703671792194,97
بفجر,2018-09-01,5686,5855,0.029722124511128715,169
بفجر,2018-09-02,5540,5686,0.026353790608961408,146
بفجر,2018-09-03,5461,5540,0.01446621497629258,79
بفجر,2018-09-04,5592,5461,0.023426323314837922,131
بفجر,2018-09-05,5530,5592,0.011211573234862283,62
بفجر,2018-09-08,5579,5530,0.008782936008463355,49
بفجر,2018-09-09,5663,5579,0.014833127315056836,84
بفجر,2018-09-10,5937,5663,0.04615125483473955,274
بفجر,2018-09-11,5831,5937,0.018178700048331553,106
بفجر,2018-09-12,6116,5831,0.04659908436124933,285
بفجر,2018-09-15,6417,6116,0.04690665419247208,301
بفجر,2018-09-16,6569,6417,0.02313898614353189,152
بفجر,2018-09-17,6897,6569,0.04755690879403263,328
بفجر,2018-09-18,7241,6897,0.04750725037322093,344
بفجر,2018-09-22,7450,7241,0.028053691271402188,209
بفجر,2018-09-23,7687,7450,0.030831273574758518,237
بفجر,2018-09-24,7414,7687,0.03682222821192039,273
بفجر,2018-09-25,7439,7414,0.0033606667558326833,25
بفجر,2018-09-26,7539,7439,0.013264358666498957,100
بفجر,2018-09-29,7719,7539,0.02331908277972288,180
بفجر,2018-09-30,8104,7719,0.04750740374537174,385
بفجر,2018-10-01,8052,8104,0.0064580228506634346,52
بفجر,2018-10-02,7661,8052,0.05103772352812456,391
بفجر,2018-10-03,7313,7661,0.04758648980615527,348
بفجر,2018-10-06,7118,7313,0.02739533576462555,195
بفجر,2018-10-07,6772,7118,0.051092734782768344,346
بفجر,2018-10-08,6490,6772,0.0434514637837517,282
بفجر,2018-10-09,6760,6490,0.039940828396458454,270
بفجر,2018-10-10,6883,6760,0.017870114772937654,123
بفجر,2018-10-13,6544,6883,0.051803178476191446,339
بفجر,2018-10-14,6469,6544,0.011593754828938976,75
بفجر,2018-10-15,6778,6469,0.04558866921723389,309
بفجر,2018-10-16,7108,6778,0.046426561614177464,330
بفجر,2018-10-17,7392,7108,0.03841991341471592,284
بفجر,2018-10-20,7705,7392,0.04062297209076924,313
بفجر,2018-10-21,7638,7705,0.008771929823412945,67
بفجر,2018-10-22,7471,7638,0.022353098645114026,167
بفجر,2018-10-23,7099,7471,0.05240174671750926,372
بفجر,2018-10-24,6789,7099,0.045662100449895104,310
بفجر,2018-10-27,6665,6789,0.018604651159999302,124
بفجر,2018-10-28,6702,6665,0.005520740076765034,37
بفجر,2018-10-29,6858,6702,0.02274715660210744,156
بفجر,2018-10-31,7019,6858,0.022937740415595136,161
بفجر,2018-11-03,7158,7019,0.019418832073285996,139
بفجر,2018-11-04,7101,7158,0.008027038444158986,57
بفجر,2018-11-05,7194,7101,0.012927439531147144,93
بفجر,2018-11-06,7239,7194,0.006216328221271401,45
بفجر,2018-11-10,7256,7239,0.0023428886435580363,17
بفجر,2018-11-11,7121,7256,0.018958011512574355,135
بفجر,2018-11-12,7008,7121,0.016124429221443432,113
بفجر,2018-11-13,7098,7008,0.012679628062457081,90
بفجر,2018-11-14,7182,7098,0.011695906431120034,84
بفجر,2018-11-17,7076,7182,0.014980214808510427,106
بفجر,2018-11-18,6909,7076,0.02417137067243141,167
بفجر,2018-11-19,7116,6909,0.029089376049875017,207
بفجر,2018-11-20,7471,7116,0.04751706598212862,355
بفجر,2018-11-21,7842,7471,0.04730935985114647,371
بفجر,2018-11-24,7547,7842,0.039088379483359165,295
بفجر,2018-11-26,7568,7547,0.0027748414372654804,21
بفجر,2018-11-27,7557,7568,0.0014556040754987952,11
بفجر,2018-11-28,7211,7557,0.04798224933463011,346
بفجر,2018-12-01,6892,7211,0.04628554845526907,319
بفجر,2018-12-02,7214,6892,0.044635431099995085,322
بفجر,2018-12-03,7525,7214,0.04132890364899283,311
بفجر,2018-12-04,7439,7525,0.01156069364006443,86
بفجر,2018-12-05,7450,7439,0.0014765100669159046,11
بفجر,2018-12-08,7451,7450,1.3421017311311095e-4,1
بفجر,2018-12-09,7516,7451,0.008648217135624239,65
بفجر,2018-12-10,7431,7516,0.011438568158869792,85
بفجر,2018-12-11,7449,7431,0.0024164317354790667,18
بفجر,2018-12-12,7395,7449,0.007302231236335059,54
بفجر,2018-12-15,7280,7395,0.01579670329453342,115
بفجر,2018-12-16,7244,7280,0.004969630037966644,36
بفجر,2018-12-17,7144,7244,0.013997760356383292,100
بفجر,2018-12-18,7213,7144,0.009566061276921382,69
بفجر,2018-12-19,7016,7213,0.02807867730500589,197
بفجر,2018-12-22,7008,7016,0.0011415525112526323,8
بفجر,2018-12-23,7100,7008,0.012957746477048204,92
بفجر,2018-12-24,7132,7100,0.004486819965719739,32
بفجر,2018-12-25,7008,7132,0.0176940639244158,124
بفجر,2018-12-26,7235,7008,0.0313752591525397,227
بفجر,2018-12-29,7513,7235,0.037002528944895176,278
بفجر,2018-12-30,7564,7513,0.006742464303709351,51
بفجر,2018-12-31,7524,7564,0.005316321105088208,40
بفجر,2019-01-01,7417,7524,0.014426317916350772,107
بفجر,2019-01-02,7411,7417,8.096073403306426e-4,6
بفجر,2019-01-09,7430,7411,0.0025572005380138357,19
بفجر,2019-01-12,7425,7430,6.734006733099797e-4,5
بفجر,2019-01-13,7210,7425,0.029819694864102676,215
بفجر,2019-01-14,7182,7210,0.0038986354770400118,28
بفجر,2019-01-15,7381,7182,0.02696111637624155,199
بفجر,2019-01-16,7289,7381,0.012621758812920597,92
بفجر,2019-01-19,7524,7289,0.031233386492393222,235
بفجر,2019-01-20,7478,7524,0.006151377372806716,46
بفجر,2019-01-21,7326,7478,0.02074802074518864,152
بفجر,2019-01-22,7393,7326,0.009062626807917945,67
بفجر,2019-01-23,7506,7393,0.015054622966286353,113
بفجر,2019-01-26,7388,7506,0.015971846234979447,118
بفجر,2019-01-27,7270,7388,0.01623108665526395,118
بفجر,2019-01-28,7290,7270,0.002743484224589371,20
بفجر,2019-01-29,7155,7290,0.01886792452566486,135
بفجر,2019-01-30,7216,7155,0.008453436805923859,61
بفجر,2019-02-02,7205,7216,0.0015267175570400115,11
بفجر,2019-02-03,7185,7205,0.0027835768959243454,20
بفجر,2019-02-04,7521,7185,0.044674910245356345,336
بفجر,2019-02-05,7856,7521,0.042642566186018,335
بفجر,2019-02-06,7739,7856,0.015118232327804853,117
بفجر,2019-02-10,7706,7739,0.004282377367728733,33
بفجر,2019-02-12,7581,7706,0.016488589893617123,125
بفجر,2019-02-13,7652,7581,0.009278619967423076,71
بفجر,2019-02-16,7581,7652,0.009365519059574525,71
بفجر,2019-02-17,7629,7581,0.006291781359773,48
بفجر,2019-02-18,7466,7629,0.021832306453009334,163
بفجر,2019-02-19,7354,7466,0.01522980690573432,112
بفجر,2019-02-20,7380,7354,0.003523035229874927,26
بفجر,2019-02-23,7535,7380,0.020570670202976687,155
بفجر,2019-02-24,7447,7535,0.011816838993981893,88
بفجر,2019-02-25,7424,7447,0.0030980603444102825,23
بفجر,2019-02-26,7203,7424,0.030681660415010182,221
بفجر,2019-02-27,7372,7203,0.022924579486852333,169
بفجر,2019-03-02,7652,7372,0.03659174071659804,280
بفجر,2019-03-03,7620,7652,0.004199475065065686,32
بفجر,2019-03-04,7490,7620,0.017356475298083245,130
بفجر,2019-03-05,7375,7490,0.015593220336868715,115
بفجر,2019-03-06,7528,7375,0.020324123270413903,153
بفجر,2019-03-09,7534,7528,7.963896999208402e-4,6
بفجر,2019-03-10,7696,7534,0.021049896047160874,162
بفجر,2019-03-11,7768,7696,0.009268795055449433,72
بفجر,2019-03-12,7853,7768,0.010823888958254948,85
بفجر,2019-03-13,8027,7853,0.02167684066006268,174
بفجر,2019-03-16,8244,8027,0.026322173698893475,217
بفجر,2019-03-17,8159,8244,0.010417943374136788,85
بفجر,2019-03-18,8218,8159,0.007179362374400175,59
بفجر,2019-03-19,8572,8218,0.041297246845392294,354
بفجر,2019-03-25,8592,8572,0.002327746740883642,20
بفجر,2019-03-26,8843,8592,0.028384032564923212,251
بفجر,2019-03-27,8676,8843,0.01924850161142825,167
بفجر,2019-03-30,8695,8676,0.002185163887040234,19
بفجر,2019-03-31,8665,8695,0.003462204269652371,30
بفجر,2019-04-06,8456,8665,0.02471617785895031,209
بفجر,2019-04-07,8379,8456,0.00918964076749139,77
بفجر,2019-04-08,8187,8379,0.023451813848363038,192
بفجر,2019-04-09,8190,8187,3.6630036625564095e-4,3
بفجر,2019-04-10,8223,8190,0.004013133892251838,33
بفجر,2019-04-13,8547,8223,0.037908037903602664,324
بفجر,2019-04-14,8649,8547,0.011793270897006212,102
بفجر,2019-04-15,8771,8649,0.013909474402701006,122
بفجر,2019-04-16,8560,8771,0.024649532707400754,211
بفجر,2019-04-17,8517,8560,0.005048726076664468,43
بفجر,2019-04-20,8519,8517,2.3476933909675202e-4,2
بفجر,2019-04-22,8518,8519,1.173984503266731e-4,1
بفجر,2019-04-23,8539,8518,0.0024593043679049884,21
بفجر,2019-04-24,8952,8539,0.04613494190726821,413
بفجر,2019-04-27,9366,8952,0.04420243433224403,414
بفجر,2019-04-28,9324,9366,0.004504504504021396,42
بفجر,2019-04-29,9766,9324,0.04525906204738285,442
بفجر,2019-04-30,10246,9766,0.04684755025894519,480
بفجر,2019-05-01,10730,10246,0.04510717613745506,484
بفجر,2019-05-04,11266,10730,0.04757677968688294,536
بفجر,2019-05-05,11186,11266,0.007151796888329001,80
بفجر,2019-05-06,10635,11186,0.05181006111407522,551
بفجر,2019-05-07,10112,10635,0.05172072784298648,523
بفجر,2019-05-08,10075,10112,0.0036724565753178703,37
بفجر,2019-05-11,10103,10075,0.002771454023283039,28
بفجر,2019-05-12,9848,10103,0.025893582450660684,255
بفجر,2019-05-13,10313,9848,0.045088722966635436,465
بفجر,2019-05-14,10801,10313,0.04518100175491334,488
بفجر,2019-05-15,10980,10801,0.01630236794022747,179
بفجر,2019-05-18,11000,10980,0.001818181818016529,20
بفجر,2019-05-19,10478,11000,0.04981866767991805,522
بفجر,2019-05-20,10199,10478,0.027355623097621764,279
بفجر,2019-05-21,10708,10199,0.04753455360034231,509
بفجر,2019-05-22,11221,10708,0.04571785045488656,513
بفجر,2019-05-25,11710,11221,0.0417591801843075,489
بفجر,2019-05-26,11953,11710,0.020329624360384036,243
بفجر,2019-05-28,11746,11953,0.017623020601258043,207
بفجر,2019-05-29,12148,11746,0.03309186697126343,402
بفجر,2019-06-01,12313,12148,0.013400471045772721,165
بفجر,2019-06-02,12446,12313,0.010686164228612714,133
بفجر,2019-06-03,12867,12446,0.032719359599539956,421
بفجر,2019-06-08,12224,12867,0.05260143978627279,643
بفجر,2019-06-09,11613,12224,0.05261345043893796,611
بفجر,2019-06-10,11167,11613,0.03993910629175794,446
بفجر,2019-06-11,11075,11167,0.00830699774191359,92
بفجر,2019-06-12,10827,11075,0.022905698714056923,248
بفجر,2019-06-15,10286,10827,0.05259576122374142,541
بفجر,2019-06-16,9747,10286,0.05529906637372534,539
بفجر,2019-06-17,9730,9747,0.0017471736894401672,17
بفجر,2019-06-18,9372,9730,0.03819889030749051,358
بفجر,2019-06-19,9669,9372,0.030716723546311227,297
بفجر,2019-06-22,9443,9669,0.02393307211437752,226
بفجر,2019-06-23,9571,9443,0.013373733150833378,128
بفجر,2019-06-24,9619,9571,0.004990123712964952,48
بفجر,2019-06-25,9557,9619,0.006487391440149901,62
بفجر,2019-06-26,9516,9557,0.00430853299660482,41
بفجر,2019-06-30,9247,9516,0.029090515839830158,269
بفجر,2019-07-01,9303,9247,0.006019563580993275,56
بفجر,2019-07-02,9508,9303,0.021560790910647793,205
بفجر,2019-07-03,9646,9508,0.014306448267229271,138
بفجر,2019-07-06,9460,9646,0.019661733613143578,186
بفجر,2019-07-24,8391,9460,0.1273984030357051,1069
بفجر,2019-07-27,8807,8391,0.04723515384952479,416
بفجر,2019-07-28,8907,8807,0.011227124732095304,100
بفجر,2019-07-29,8895,8907,0.0013490725124958884,12
بفجر,2019-07-30,8742,8895,0.01750171585249351,153
بفجر,2019-07-31,8820,8742,0.008843537413963317,78
بفجر,2019-08-03,8701,8820,0.013676588896255995,119
بفجر,2019-08-04,8689,8701,0.001381056508069852,12
بفجر,2019-08-05,8738,8689,0.005607690546394176,49
بفجر,2019-08-06,8709,8738,0.0033298886205844654,29
بفجر,2019-08-07,8826,8709,0.013256288237791038,117
بفجر,2019-08-10,9258,8826,0.046662346074026535,432
بفجر,2019-08-11,9448,9258,0.020110076204476073,190
بفجر,2019-08-13,9241,9448,0.02240017313901091,207
بفجر,2019-08-14,9332,9241,0.009751393055105938,91
بفجر,2019-08-17,9272,9332,0.00647109577151951,60
بفجر,2019-08-18,9495,9272,0.023486045284519638,223
بفجر,2019-08-24,10156,9495,0.06508467900107476,661
بفجر,2019-08-25,9712,10156,0.04571663920451847,444
بفجر,2019-08-26,9802,9712,0.009181799631791287,90
بفجر,2019-08-27,9725,9802,0.007917737788388921,77
بفجر,2019-08-28,9710,9725,0.0015447991759480124,15
بفجر,2019-08-31,9717,9710,7.203869506308133e-4,7
بفجر,2019-09-01,9607,9717,0.011449984385193089,110
بفجر,2019-09-02,9316,9607,0.031236582220777524,291
بفجر,2019-09-03,9368,9316,0.005550811271824209,52
بفجر,2019-09-04,9439,9368,0.007521983260141754,71
بفجر,2019-09-07,9619,9439,0.01871296392361857,180
بفجر,2019-09-08,10095,9619,0.047152055468335605,476
بفجر,2019-09-11,10599,10095,0.04755165581210004,504
بفجر,2019-09-14,10641,10599,0.003946997462273565,42
بفجر,2019-09-15,10412,10641,0.021993853244141964,229
بفجر,2019-09-16,10722,10412,0.028912516318885233,310
بفجر,2019-09-17,10278,10722,0.04319906596193821,444
بفجر,2019-09-18,9828,10278,0.0457875457828869,450
بفجر,2019-09-21,9741,9828,0.008931321218670431,87
بفجر,2019-09-22,10023,9741,0.028135288832870867,282
بفجر,2019-09-23,10336,10023,0.03028250773700827,313
بفجر,2019-09-24,10163,10336,0.017022532715042553,173
بفجر,2019-09-25,10275,10163,0.010900243307941582,112
بفجر,2019-09-28,10255,10275,0.00195026816168208,20
بفجر,2019-09-29,10076,10255,0.01776498610383436,179
بفجر,2019-09-30,10528,10076,0.04293313069501015,452
بفجر,2019-10-01,10666,10528,0.012938308643077226,138
بفجر,2019-10-02,10754,10666,0.00818300167303487,88
بفجر,2019-10-05,10886,10754,0.012125665991904679,132
بفجر,2019-10-06,10492,10886,0.03755242088852912,394
بفجر,2019-10-07,10472,10492,0.0019098548508489444,20
بفجر,2019-10-08,10034,10472,0.04365158460796775,438
بفجر,2019-10-09,9881,10034,0.015484262724877617,153
بفجر,2019-10-12,10159,9881,0.02736489811720003,278
بفجر,2019-10-13,10391,10159,0.022327013759760657,232
بفجر,2019-10-14,10393,10391,1.9243721733932097e-4,2
بفجر,2019-10-15,9925,10393,0.047153652388196104,468
بفجر,2019-10-16,9806,9925,0.012135427288177092,119
بفجر,2019-10-20,9369,9806,0.04664318496673677,437
بفجر,2019-10-21,9471,9369,0.01076971808565413,102
بفجر,2019-10-22,9665,9471,0.020072426278316353,194
بفجر,2019-10-23,9526,9665,0.014591643920366193,139
بفجر,2019-10-26,9492,9526,0.003581963758577543,34
بفجر,2019-10-28,9713,9492,0.022753011425640582,221
بفجر,2019-10-30,9783,9713,0.007155269344050366,70
بفجر,2019-11-02,9679,9783,0.010744911663318016,104
بفجر,2019-11-03,9676,9679,3.1004547330404657e-4,3
بفجر,2019-11-04,9460,9676,0.02283298097010222,216
بفجر,2019-11-05,9494,9460,0.003581209184371054,34
بفجر,2019-11-09,9498,9494,4.211412928594292e-4,4
بفجر,2019-11-10,9243,9498,0.027588445306979504,255
بفجر,2019-11-11,9161,9243,0.008950987882441764,82
بفجر,2019-11-12,9305,9161,0.01547555077748785,144
بفجر,2019-11-13,9546,9305,0.02524617640632242,241
بفجر,2019-11-16,9594,9546,0.005003126953824982,48
بفجر,2019-11-17,9458,9594,0.014379361385665113,136
بفجر,2019-11-18,9417,9458,0.004353828182610828,41
بفجر,2019-11-19,9481,9417,0.006750342790132861,64
بفجر,2019-11-20,9428,9481,0.005621552820786853,53
بفجر,2019-11-23,9592,9428,0.01709758131598232,164
بفجر,2019-11-24,9604,9592,0.0012494793834600707,12
بفجر,2019-11-25,9941,9604,0.033900010055940046,337
بفجر,2019-11-26,10115,9941,0.017202174985941454,174
بفجر,2019-11-27,10074,10115,0.004069882866381786,41
بفجر,2019-11-30,10357,10074,0.027324514818255815,283
بفجر,2019-12-01,10652,10357,0.027694329700742176,295
بفجر,2019-12-02,10796,10652,0.013338273433369926,144
بفجر,2019-12-03,10647,10796,0.013994552454776505,149
بفجر,2019-12-04,10463,10647,0.01758577845574063,184
بفجر,2019-12-07,10830,10463,0.03388734995070292,367
بفجر,2019-12-08,10671,10830,0.014900196793655684,159
بفجر,2019-12-09,10644,10671,0.0025366403605283127,27
بفجر,2019-12-10,10818,10644,0.016084303936394498,174
بفجر,2019-12-11,10817,10818,9.244707404155985e-5,1
بفجر,2019-12-14,11241,10817,0.03771906413684556,424
بفجر,2019-12-17,11927,11241,0.05751655906283922,686
بفجر,2019-12-18,12178,11927,0.020610937754917808,251
بفجر,2019-12-21,12404,12178,0.018219929053674627,226
بفجر,2019-12-22,12189,12404,0.01763885470361483,215
بفجر,2019-12-23,12168,12189,0.0017258382641579684,21
بفجر,2019-12-24,12349,12168,0.014657057250412418,181
بفجر,2019-12-25,12350,12349,8.097165991247192e-5,1
بفجر,2019-12-28,12403,12350,0.004273159719078194,53
بفجر,2019-12-29,12356,12403,0.003803820006166735,47
بفجر,2019-12-30,12553,12356,0.015693459729491478,197
بفجر,2019-12-31,12443,12553,0.008840311821197435,110
بفجر,2020-01-01,12708,12443,0.0208530059788438,265
بفجر,2020-01-04,12073,12708,0.05259670338336812,635
بفجر,2020-01-05,12212,12073,0.011382246969261198,139
بفجر,2020-01-07,11764,12212,0.03808228493385904,448
بفجر,2020-01-08,11529,11764,0.020383381037350733,235
بفجر,2020-01-11,11759,11529,0.019559486349216813,230
بفجر,2020-01-12,12322,11759,0.04569063463352616,563
بفجر,2020-01-13,12806,12322,0.037794783692191566,484
بفجر,2020-01-14,12557,12806,0.01982957712671581,249
بفجر,2020-01-15,12523,12557,0.002715004391702068,34
بفجر,2020-01-18,12740,12523,0.017032967031630066,217
بفجر,2020-01-19,12597,12740,0.011351909183825361,143
بفجر,2020-01-20,12514,12597,0.006632571519367702,83
بفجر,2020-01-21,12723,12514,0.016426943329684276,209
بفجر,2020-01-22,12879,12723,0.012112741671549597,156
بفجر,2020-01-25,13009,12879,0.0099930817118923,130
بفجر,2020-01-26,13659,13009,0.047587671129102595,650
بفجر,2020-01-27,14306,13659,0.04522577939010025,647
بفجر,2020-01-28,14955,14306,0.04339685723547998,649
بفجر,2020-02-01,14280,14955,0.04726890755971506,675
بفجر,2020-02-02,14261,14280,0.0013323048873618746,19
بفجر,2020-02-03,14743,14261,0.03269348165009201,482
بفجر,2020-02-04,14219,14743,0.03685209930115675,524
بفجر,2020-02-05,13975,14219,0.017459749551523452,244
بفجر,2020-02-08,14065,13975,0.006398862424002925,90
بفجر,2020-02-09,14090,14065,0.0017743080197463231,25
بفجر,2020-02-10,13669,14090,0.03079961957489212,421
بفجر,2020-02-12,13781,13669,0.00812713155735236,112
بفجر,2020-02-15,13910,13781,0.009273903665760324,129
بفجر,2020-02-16,14425,13910,0.035701906410003335,515
بفجر,2020-02-17,14851,14425,0.028684937039345167,426
بفجر,2020-02-18,14636,14851,0.014689805956908322,215
بفجر,2020-02-19,14348,14636,0.0200724839684923,288
بفجر,2020-02-22,14015,14348,0.023760256865946468,333
بفجر,2020-02-23,14519,14015,0.03471313451100536,504
بفجر,2020-02-24,14073,14519,0.03169189227373752,446
بفجر,2020-02-25,14515,14073,0.030451257317915863,442
بفجر,2020-02-26,14429,14515,0.005960219002982867,86
بفجر,2020-02-29,13844,14429,0.042256573241674616,585
بفجر,2020-03-01,14379,13844,0.03720703803900083,535
بفجر,2020-03-02,14915,14379,0.03593697619604848,536
بفجر,2020-03-03,15658,14915,0.04745178183373025,743
بفجر,2020-03-04,16440,15658,0.04756690997277573,782
بفجر,2020-03-07,16063,16440,0.02347008653281018,377
بفجر,2020-03-09,15366,16063,0.04535988545845634,697
بفجر,2020-03-10,14652,15366,0.048730548727222864,714
بفجر,2020-03-11,14581,14652,0.004869350524321422,71
بفجر,2020-03-14,14099,14581,0.03418682175798377,482
بفجر,2020-03-15,13737,14099,0.026352187520830444,362
بفجر,2020-03-16,14086,13737,0.024776373702628397,349
بفجر,2020-03-17,13850,14086,0.017039711190105434,236
بفجر,2020-03-18,14084,13850,0.01661459812435284,234
بفجر,2020-03-24,13742,14084,0.02488720710050304,342
بفجر,2020-03-25,14342,13742,0.04183516942951923,600
بفجر,2020-03-28,15037,14342,0.046219325660289995,695
بفجر,2020-03-29,15541,15037,0.03243034553552343,504
بفجر,2020-03-30,16307,15541,0.04697369227650863,766
بفجر,2020-04-04,17102,16307,0.04648579113282155,795
بفجر,2020-04-05,17805,17102,0.03948329120811664,703
بفجر,2020-04-06,18452,17805,0.035063949705448516,647
بفجر,2020-04-07,18559,18452,0.0057653968421916375,107
بفجر,2020-04-08,18761,18559,0.01076701668297175,202
بفجر,2020-04-11,19557,18761,0.04070153908878143,796
بفجر,2020-04-12,20257,19557,0.03455595596413309,700
بفجر,2020-04-13,19356,20257,0.046548873731837734,901
بفجر,2020-04-14,18782,19356,0.030561175592026344,574
بفجر,2020-04-15,19636,18782,0.04349154613752844,854
بفجر,2020-04-18,20507,19636,0.042473301797314414,871
بفجر,2020-04-19,20284,20507,0.010993886806793833,223
بفجر,2020-04-20,20593,20284,0.015005098819258723,309
بفجر,2020-04-21,20867,20593,0.013130780657826675,274
بفجر,2020-04-22,21443,20867,0.0268619129773417,576
بفجر,2020-04-25,22478,21443,0.046045021797044,1035
بفجر,2020-04-26,22735,22478,0.011304156586263287,257
بفجر,2020-04-27,23342,22735,0.026004626851769144,607
بفجر,2020-04-28,24468,23342,0.04601929049999921,1126
بفجر,2020-04-29,25683,24468,0.04730755752648415,1215
بفجر,2020-05-02,26967,25683,0.04761375013729322,1284
بفجر,2020-05-03,28297,26967,0.047001448915185304,1330
بفجر,2020-05-04,27114,28297,0.04363059673808252,1183
بفجر,2020-05-05,26008,27114,0.042525376805501176,1106
بفجر,2020-05-09,29184,26008,0.10882675438223592,3176
بفجر,2020-05-10,28179,29184,0.03566485680699582,1005
بفجر,2020-05-11,26918,28179,0.046845976668146,1261
بفجر,2020-05-12,25598,26918,0.05156652863303514,1320
بفجر,2020-05-13,24506,25598,0.044560515790232576,1092
بفجر,2020-05-16,23324,24506,0.050677413820499166,1182
بفجر,2020-05-17,24043,23324,0.02990475398120431,719
بفجر,2020-05-18,24781,24043,0.029780880512094713,738
بفجر,2020-05-19,24548,24781,0.009491608277273439,233
بفجر,2020-05-20,25756,24548,0.04690169280762146,1208
بفجر,2020-05-23,26634,25756,0.032965382592439536,878
بفجر,2020-05-26,25726,26634,0.035295032261708194,908
بفجر,2020-05-27,26698,25726,0.036407221513356534,972
بفجر,2020-05-30,28004,26698,0.04663619482764476,1306
بفجر,2020-05-31,27151,28004,0.03141689072109989,853
بفجر,2020-06-01,28206,27151,0.037403389348457654,1055
بفجر,2020-06-02,29489,28206,0.04350774865056435,1283
بفجر,2020-06-06,30963,29489,0.04760520621233068,1474
بفجر,2020-06-07,32511,30963,0.047614653500427095,1548
بفجر,2020-06-08,34131,32511,0.04746418212043409,1620
بفجر,2020-06-09,35570,34131,0.04045543997637179,1439
بفجر,2020-06-13,36330,35570,0.02091935039854337,760
بفجر,2020-06-14,36860,36330,0.014378730330592004,530
بفجر,2020-06-15,38410,36860,0.040354074458725485,1550
بفجر,2020-06-16,40070,38410,0.0414275018706906,1660
بفجر,2020-06-20,42000,40070,0.04595238095128685,1930
بفجر,2020-06-21,41250,42000,0.018181818181377412,750
بفجر,2020-06-22,42380,41250,0.02666352052792205,1130
بفجر,2020-06-23,43060,42380,0.015791918253232885,680
بفجر,2020-06-24,41110,43060,0.047433714423560355,1950
بفجر,2020-06-27,41630,41110,0.012490992072724213,520
بفجر,2020-06-28,39780,41630,0.04650578179873037,1850
بفجر,2020-06-29,38500,39780,0.033246753245889694,1280
بفجر,2020-06-30,40400,38500,0.047029702969132926,1900
بفجر,2020-07-01,42400,40400,0.04716981131964222,2000
بفجر,2020-07-04,42730,42400,0.0077229113033530795,330
بفجر,2020-07-05,44010,42730,0.029084299022288474,1280
بفجر,2020-07-06,45830,44010,0.03971197905215553,1820
بفجر,2020-07-07,44760,45830,0.023905272564255915,1070
بفجر,2020-07-08,42590,44760,0.05095092744656138,2170
بفجر,2020-07-11,40480,42590,0.052124505927566095,2110
بفجر,2020-07-12,40720,40480,0.005893909626574314,240
بفجر,2020-07-13,38750,40720,0.05083870967610739,1970
بفجر,2020-07-14,37180,38750,0.04222700376432956,1570
بفجر,2020-07-20,35760,37180,0.039709172258397395,1420
بفجر,2020-07-21,37170,35760,0.03793381759381399,1410
بفجر,2020-07-22,36830,37170,0.009231604669855238,340
بفجر,2020-07-25,36330,36830,0.01376273052535748,500
بفجر,2020-07-26,34670,36330,0.047880011535971156,1660
بفجر,2020-07-27,33110,34670,0.047115675021228764,1560
بفجر,2020-07-28,32970,33110,0.004246284500932779,140
بفجر,2020-07-29,34120,32970,0.033704572097488145,1150
بفجر,2020-08-01,35380,34120,0.03561334086954174,1260
بفجر,2020-08-02,37040,35380,0.044816414685615105,1660
بفجر,2020-08-03,35290,37040,0.04958911872911337,1750
بفجر,2020-08-04,34950,35290,0.009728183118462713,340
بفجر,2020-08-05,35300,34950,0.009915014164025071,350
بفجر,2020-08-09,36940,35300,0.04439631835288586,1640
بفجر,2020-08-10,35660,36940,0.035894559729784226,1280
بفجر,2020-08-11,33920,35660,0.05129716980980845,1740
بفجر,2020-08-12,32540,33920,0.042409342346576236,1380
بفجر,2020-08-15,30930,32540,0.05205302295337688,1610
بفجر,2020-08-16,29680,30930,0.04211590296354057,1250
بفجر,2020-08-17,30240,29680,0.018518518517906132,560
بفجر,2020-08-18,31220,30240,0.03139013452814253,980
بفجر,2020-08-19,29760,31220,0.04905913978329774,1460
بفجر,2020-08-22,28960,29760,0.027624309391311316,800
بفجر,2020-08-23,27630,28960,0.04813608396496069,1330
بفجر,2020-08-24,26290,27630,0.05096995054960175,1340
بفجر,2020-08-25,26340,26290,0.0018982536066097853,50
بفجر,2020-08-26,27650,26340,0.04737793851546553,1310
بفجر,2020-08-31,26990,27650,0.024453501295870563,660
بفجر,2020-09-01,25960,26990,0.03967642526811724,1030
بفجر,2020-09-02,25010,25960,0.03798480607605019,950
بفجر,2020-09-05,26240,25010,0.0468749999982136,1230
بفجر,2020-09-06,26620,26240,0.014274981216593726,380
بفجر,2020-09-07,25580,26620,0.04065676309457948,1040
بفجر,2020-09-08,24530,25580,0.04280472890163862,1050
بفجر,2020-09-09,25400,24530,0.034251968502588506,870
غالبر,2018-01-15,1319,1351,0.024260803620727214,32
غالبر,2018-01-16,1327,1319,0.006028636016557169,8
غالبر,2018-01-17,1345,1327,0.013382899618302677,18
غالبر,2018-01-20,1290,1345,0.04263565888167778,55
غالبر,2018-01-21,1268,1290,0.017350157715023535,22
غالبر,2018-01-22,1279,1268,0.008600469109772893,11
غالبر,2018-01-23,1280,1279,7.812499993896483e-4,1
غالبر,2018-01-24,1284,1280,0.003115264795081569,4
غالبر,2018-01-27,1270,1284,0.011023622038564076,14
غالبر,2018-01-28,1258,1270,0.00953895070783867,12
غالبر,2018-01-29,1244,1258,0.011254019283557862,14
غالبر,2018-01-30,1302,1244,0.04454685096424973,58
غالبر,2018-01-31,1308,1302,0.004587155959795752,6
غالبر,2018-02-03,1286,1308,0.017107309473477984,22
غالبر,2018-02-04,1252,1286,0.027156549499076237,34
غالبر,2018-02-05,1294,1252,0.03245749611092929,42
غالبر,2018-02-06,1349,1294,0.04077094140787921,55
غالبر,2018-02-07,1381,1349,0.02317161475512555,32
غالبر,2018-02-10,1336,1381,0.03368263470532737,45
غالبر,2018-02-12,1338,1336,0.0014947683097946425,2
غالبر,2018-02-13,1350,1338,0.008888888882304526,12
غالبر,2018-02-14,1356,1350,0.004424778757798836,6
غالبر,2018-02-17,1358,1356,0.0014727540489891354,2
غالبر,2018-02-18,1361,1358,0.002204261570753665,3
غالبر,2018-02-19,1384,1361,0.016618497097819002,23
غالبر,2018-02-21,1343,1384,0.03052866714033606,41
غالبر,2018-02-24,1318,1343,0.018968133521268485,25
غالبر,2018-02-25,1280,1318,0.029687499976806638,38
غالبر,2018-02-26,1276,1280,0.003134796235787777,4
غالبر,2018-02-27,1306,1276,0.022970903504616457,30
غالبر,2018-02-28,1300,1306,0.0046153846118343195,6
غالبر,2018-03-03,1301,1300,7.68639507479908e-4,1
غالبر,2018-03-04,1299,1301,0.0015396458802620122,2
غالبر,2018-03-05,1299,1299,0,0
غالبر,2018-03-06,1304,1299,0.0038343558252804015,5
غالبر,2018-03-07,1299,1304,0.003849114700655031,5
غالبر,2018-03-10,1301,1299,0.001537279014959816,2
غالبر,2018-03-11,1282,1301,0.014820592812152422,19
غالبر,2018-03-12,1279,1282,0.0023455824844835164,3
غالبر,2018-03-13,1257,1279,0.017501988848447104,22
غالبر,2018-03-14,1257,1257,0,0
غالبر,2018-03-17,1258,1257,7.949125589865559e-4,1
غالبر,2018-03-18,1274,1258,0.012558869691869017,16
غالبر,2018-03-19,1299,1274,0.019245573503275153,25
غالبر,2018-03-25,1295,1299,0.0030888030864179125,4
غالبر,2018-03-26,1289,1295,0.00465477113680778,6
غالبر,2018-03-27,1287,1289,0.0015540015527940934,2
غالبر,2018-03-28,1280,1287,0.005468749995727539,7
غالبر,2018-04-03,1276,1280,0.003134796235787777,4
غالبر,2018-04-04,1290,1276,0.010852713169881617,14
غالبر,2018-04-07,1342,1290,0.03874813707991942,52
غالبر,2018-04-08,1291,1342,0.039504260232762,51
غالبر,2018-04-09,1284,1291,0.005451713391392746,7
غالبر,2018-04-10,1289,1284,0.0038789759473398166,5
غالبر,2018-04-11,1251,1289,0.030375699416166503,38
غالبر,2018-04-15,1248,1251,0.0024038461519199947,3
غالبر,2018-04-16,1251,1248,0.00239808153285525,3
غالبر,2018-04-17,1267,1251,0.01262825571221132,16
غالبر,2018-04-18,1288,1267,0.0163043478134283,21
غالبر,2018-04-21,1310,1288,0.016793893116951224,22
غالبر,2018-04-22,1292,1310,0.013931888534108445,18
غالبر,2018-04-23,1294,1292,0.0015455950529013947,2
غالبر,2018-04-24,1280,1294,0.010937499991455078,14
غالبر,2018-04-25,1277,1280,0.002349256067071843,3
غالبر,2018-04-28,1263,1277,0.011084718914422233,14
غالبر,2018-04-29,1252,1263,0.008785942484995252,11
غالبر,2018-04-30,1255,1252,0.0023904382451072205,3
غالبر,2018-05-01,1252,1255,0.0023961661322714324,3
غالبر,2018-05-05,1254,1252,0.0015948963304665898,2
غالبر,2018-05-06,1229,1254,0.020341741236499802,25
غالبر,2018-05-07,1204,1229,0.020764119584082957,25
غالبر,2018-05-08,1216,1204,0.0098684210445161,12
غالبر,2018-05-09,1179,1216,0.03138252753911575,37
غالبر,2018-05-12,1186,1179,0.005902192237856498,7
غالبر,2018-05-13,1232,1186,0.03733766230735579,46
غالبر,2018-05-14,1270,1232,0.029921259818959635,38
غالبر,2018-05-15,1259,1270,0.008737092923957829,11
غالبر,2018-05-16,1246,1259,0.010433386829507714,13
غالبر,2018-05-19,1279,1246,0.02580140732931868,33
غالبر,2018-05-20,1334,1279,0.04122938527643974,55
غالبر,2018-05-21,1359,1334,0.018395879309495305,25
غالبر,2018-05-22,1401,1359,0.029978586702370743,42
غالبر,2018-05-23,1448,1401,0.032458563513495464,47
غالبر,2018-05-26,1409,1448,0.02767920509036252,39
غالبر,2018-05-27,1422,1409,0.009142053439421902,13
غالبر,2018-05-28,1383,1422,0.02819956614013046,39
غالبر,2018-05-29,1347,1383,0.026726057886617624,36
غالبر,2018-05-30,1394,1347,0.0337159253703616,47
غالبر,2018-06-02,1404,1394,0.007122507117434111,10
غالبر,2018-06-03,1377,1404,0.01960784312301536,27
غالبر,2018-06-09,1365,1377,0.008791208784768344,12
غالبر,2018-06-10,1409,1365,0.031227821127588484,44
غالبر,2018-06-11,1469,1409,0.04084411161276779,60
غالبر,2018-06-12,1512,1469,0.028439153420344473,43
غالبر,2018-06-13,1528,1512,0.010471204181628791,16
غالبر,2018-06-17,1540,1528,0.007792207787147916,12
غالبر,2018-06-18,1494,1540,0.030789825949939873,46
غالبر,2018-06-19,1477,1494,0.011509817189228288,17
غالبر,2018-06-20,1508,1477,0.02055702916408685,31
غالبر,2018-06-23,1519,1508,0.007241606315179982,11
غالبر,2018-06-24,1574,1519,0.03494282081642768,55
غالبر,2018-06-25,1591,1574,0.010685103701643554,17
غالبر,2018-06-26,1514,1591,0.05085865254236548,77
غالبر,2018-06-27,1447,1514,0.046302695199514375,67
غالبر,2018-06-30,1415,1447,0.022614840973417073,32
غالبر,2018-07-01,1383,1415,0.023138105550876278,32
غالبر,2018-07-02,1373,1383,0.007283321189159998,10
غالبر,2018-07-03,1372,1373,7.288629732296916e-4,1
غالبر,2018-07-04,1354,1372,0.013293943860196495,18
غالبر,2018-07-07,1352,1354,0.0014792899397342528,2
غالبر,2018-07-08,1333,1352,0.014253563380154865,19
غالبر,2018-07-10,1305,1333,0.021455938680876672,28
غالبر,2018-07-11,1281,1305,0.0187353629830325,24
غالبر,2018-07-14,1284,1281,0.0023364485963111767,3
غالبر,2018-07-15,1285,1284,7.782101161259064e-4,1
غالبر,2018-07-16,1286,1285,7.776049760671812e-4,1
غالبر,2018-07-17,1297,1286,0.008481110247894287,11
غالبر,2018-07-18,1310,1297,0.009923664114562088,13
غالبر,2018-07-24,1269,1310,0.032308904623870045,41
غالبر,2018-07-25,1258,1269,0.008744038148852116,11
غالبر,2018-07-28,1308,1258,0.0382262996649646,50
غالبر,2018-07-29,1319,1308,0.00833965124462498,11
غالبر,2018-07-30,1262,1319,0.04516640249986814,57
غالبر,2018-07-31,1323,1262,0.04610733178676694,61
غالبر,2018-08-01,1327,1323,0.0030143180082785846,4
غالبر,2018-08-15,1283,1327,0.03429462195300497,44
غالبر,2018-08-18,1338,1283,0.041106128519352664,55
غالبر,2018-08-19,1328,1338,0.007530120476257438,10
غالبر,2018-08-20,1322,1328,0.004538577908821045,6
غالبر,2018-08-21,1307,1322,0.011476664107515942,15
غالبر,2018-08-25,1363,1307,0.04108584002855037,56
غالبر,2018-08-26,1427,1363,0.04484933423626535,64
غالبر,2018-08-27,1455,1427,0.019243986241069422,28
غالبر,2018-08-28,1412,1455,0.030453257768800805,43
غالبر,2018-08-29,1431,1412,0.013277428362489567,19
غالبر,2018-09-01,1471,1431,0.027192386113397426,40
غالبر,2018-09-02,1420,1471,0.03591549293245388,51
غالبر,2018-09-03,1406,1420,0.009957325739717407,14
غالبر,2018-09-04,1405,1406,7.117437717354137e-4,1
غالبر,2018-09-05,1461,1405,0.03832991099361402,56
غالبر,2018-09-08,1526,1461,0.04259501963132698,65
غالبر,2018-09-09,1572,1526,0.02926208649538035,46
غالبر,2018-09-10,1629,1572,0.034990791875389324,57
غالبر,2018-09-11,1704,1629,0.04401408448121239,75
غالبر,2018-09-12,1866,1704,0.08681672021070914,162
غالبر,2018-09-15,1902,1866,0.018927444785001343,36
غالبر,2018-09-16,1820,1902,0.045054945030189586,82
غالبر,2018-09-17,1906,1820,0.04512067153981077,86
غالبر,2018-09-18,1955,1906,0.0250639386061054,49
غالبر,2018-09-22,2052,1955,0.04727095514265548,97
غالبر,2018-09-23,2151,2052,0.04602510458111339,99
غالبر,2018-09-29,2369,2151,0.09202195015110935,218
غالبر,2018-09-30,2487,2369,0.04744672294031093,118
غالبر,2018-10-01,2528,2487,0.01621835442396426,41
غالبر,2018-10-02,2452,2528,0.03099510602324833,76
غالبر,2018-10-03,2330,2452,0.052360514998986904,122
غالبر,2018-10-06,2273,2330,0.025076990750076116,57
غالبر,2018-10-07,2160,2273,0.05231481479059499,113
غالبر,2018-10-08,2080,2160,0.03846153844304734,80
غالبر,2018-10-09,1991,2080,0.04470115517594116,89
غالبر,2018-10-10,1892,1991,0.05232558136769261,99
غالبر,2018-10-13,1842,1892,0.027144408237163728,50
غالبر,2018-10-14,1771,1842,0.0400903444155334,71
غالبر,2018-10-15,1775,1771,0.002253521125490974,4
غالبر,2018-10-16,1851,1775,0.0410588870658785,76
غالبر,2018-10-17,1788,1851,0.03523489930915274,63
غالبر,2018-10-20,1860,1788,0.03870967739854318,72
غالبر,2018-10-21,1884,1860,0.012738853496423112,24
غالبر,2018-10-22,1820,1884,0.03516483514551382,64
غالبر,2018-10-23,1731,1820,0.05141536681027419,89
غالبر,2018-10-24,1716,1731,0.008741258736164766,15
غالبر,2018-10-27,1714,1716,0.001166861142843138,2
غالبر,2018-10-28,1770,1714,0.03163841806122123,56
غالبر,2018-10-29,1851,1770,0.043760129636002086,81
غالبر,2018-10-31,1926,1851,0.03894080994862886,75
غالبر,2018-11-03,1918,1926,0.004171011468106876,8
غالبر,2018-11-04,1854,1918,0.03451995683143476,64
غالبر,2018-11-05,1905,1854,0.026771653529253724,51
غالبر,2018-11-06,1970,1905,0.03299492384111933,65
غالبر,2018-11-10,2066,1970,0.046466602107228173,96
غالبر,2018-11-11,2114,2066,0.022705771039401246,48
غالبر,2018-11-12,2159,2114,0.020842982852782316,45
غالبر,2018-11-13,2098,2159,0.029075309805016537,61
غالبر,2018-11-14,2004,2098,0.04690618760134421,94
غالبر,2018-11-17,1958,2004,0.023493360560013603,46
غالبر,2018-11-18,1882,1958,0.04038257171074252,76
غالبر,2018-11-19,1910,1882,0.014659685856199117,28
غالبر,2018-11-20,1977,1910,0.033889731899904026,67
غالبر,2018-11-21,2067,1977,0.04354136427501627,90
غالبر,2018-11-24,1972,2067,0.04817444216624014,95
غالبر,2018-11-26,1893,1972,0.041732699396865976,79
غالبر,2018-11-27,1904,1893,0.005777310921335445,11
غالبر,2018-11-28,1846,1904,0.0314192849233915,58
غالبر,2018-12-01,1772,1846,0.0417607223240628,74
غالبر,2018-12-02,1804,1772,0.01773835919194104,32
غالبر,2018-12-03,1815,1804,0.006060606057266884,11
غالبر,2018-12-04,1776,1815,0.021959459447094896,39
غالبر,2018-12-05,1791,1776,0.00837520937555823,15
غالبر,2018-12-08,1806,1791,0.008305647835932642,15
غالبر,2018-12-09,1788,1806,0.010067114088329355,18
غالبر,2018-12-10,1790,1788,0.0011173184351299897,2
غالبر,2018-12-11,1868,1790,0.041755888628610335,78
غالبر,2018-12-12,1884,1868,0.00849256899761541,16
غالبر,2018-12-15,1838,1884,0.025027203468429158,46
غالبر,2018-12-16,1782,1838,0.03142536474106321,56
غالبر,2018-12-17,1771,1782,0.006211180120716442,11
غالبر,2018-12-18,1749,1771,0.012578616345009367,22
غالبر,2018-12-19,1743,1749,0.0034423407897634303,6
غالبر,2018-12-22,1743,1743,0,0
غالبر,2018-12-23,1743,1743,0,0
غالبر,2018-12-24,1744,1743,5.733944950840628e-4,1
غالبر,2018-12-25,1731,1744,0.007510109758804095,13
غالبر,2018-12-26,1783,1731,0.029164329764910638,52
غالبر,2018-12-29,1859,1783,0.040882194706357074,76
غالبر,2018-12-30,1868,1859,0.004817987149455039,9
غالبر,2018-12-31,1840,1868,0.015217391296077503,28
غالبر,2019-01-01,1819,1840,0.011544804831476192,21
غالبر,2019-01-02,1779,1819,0.02248454186482038,40
غالبر,2019-01-05,1802,1779,0.012763595997356493,23
غالبر,2019-01-06,1818,1802,0.008800880083167833,16
غالبر,2019-01-07,1792,1818,0.014508928563332071,26
غالبر,2019-01-08,1786,1792,0.0033594624841212415,6
غالبر,2019-01-09,1855,1786,0.037196765478600124,69
غالبر,2019-01-12,1901,1855,0.02419779062377812,46
غالبر,2019-01-13,1914,1901,0.006792058512647827,13
غالبر,2019-01-14,1949,1914,0.017957927132910247,35
غالبر,2019-01-15,1900,1949,0.02578947367063712,49
غالبر,2019-01-16,1942,1900,0.021627188454362928,42
غالبر,2019-01-19,1921,1942,0.010931806345168242,21
غالبر,2019-01-20,1890,1921,0.016402116393438033,31
غالبر,2019-01-21,1802,1890,0.04883462816379876,88
غالبر,2019-01-22,1861,1802,0.031703385259697264,59
غالبر,2019-01-23,1902,1861,0.02155625656069597,41
غالبر,2019-01-26,1973,1902,0.035985808395344245,71
غالبر,2019-01-27,1979,1973,0.0030318342581951317,6
غالبر,2019-01-28,2008,1979,0.014442231068504865,29
غالبر,2019-01-29,2026,2008,0.008884501476365004,18
غالبر,2019-01-30,2059,2026,0.01602719766098728,33
غالبر,2019-02-02,1985,2059,0.03727959695854932,74
غالبر,2019-02-03,1924,1985,0.031704781688303124,61
غالبر,2019-02-04,1916,1924,0.0041753653422884314,8
غالبر,2019-02-05,1985,1916,0.03476070527216085,69
غالبر,2019-02-06,1956,1985,0.01482617586154081,29
غالبر,2019-02-10,1932,1956,0.012422360242017412,24
غالبر,2019-02-12,1933,1932,5.173305739693064e-4,1
غالبر,2019-02-13,1883,1933,0.02655337226417771,50
غالبر,2019-02-16,1858,1883,0.013455328302768929,25
غالبر,2019-02-17,1891,1858,0.017451084073267537,33
غالبر,2019-02-18,1898,1891,0.0036880927272454726,7
غالبر,2019-02-19,1880,1898,0.00957446808001358,18
غالبر,2019-02-20,1899,1880,0.010005265924167842,19
غالبر,2019-02-23,1924,1899,0.012993762987009478,25
غالبر,2019-02-24,2011,1924,0.04326205865576228,87
غالبر,2019-02-25,1986,2011,0.01258811681138564,25
غالبر,2019-02-26,1922,1986,0.033298647225130776,64
غالبر,2019-02-27,1947,1922,0.012840267070960315,25
غالبر,2019-03-02,1952,1947,0.0025614754085238342,5
غالبر,2019-03-03,1924,1952,0.014553014545450615,28
غالبر,2019-03-04,1917,1924,0.0036515388609016488,7
غالبر,2019-03-05,1916,1917,5.219206677860539e-4,1
غالبر,2019-03-06,1925,1916,0.004675324672895935,9
غالبر,2019-04-23,2467,1925,0.2197000404460073,542
غالبر,2019-04-24,2545,2467,0.030648330046896533,78
غالبر,2019-04-27,2672,2545,0.04752994010197233,127
غالبر,2019-04-28,2805,2672,0.047415329751367086,133
غالبر,2019-04-29,2938,2805,0.0452688903862257,133
غالبر,2019-04-30,3073,2938,0.04393101202605564,135
غالبر,2019-05-01,3226,3073,0.04742715435603622,153
غالبر,2019-05-04,3387,3226,0.047534691453340806,161
غالبر,2019-05-05,3515,3387,0.03641536272079222,128
غالبر,2019-05-06,3427,3515,0.025678435942317352,88
غالبر,2019-05-07,3263,3427,0.05026049646023276,164
غالبر,2019-05-08,3384,3263,0.035756501171466754,121
غالبر,2019-05-11,3527,3384,0.040544371976029385,143
غالبر,2019-05-12,3412,3527,0.03370457208859772,115
غالبر,2019-05-13,3559,3412,0.04130373699317119,147
غالبر,2019-05-14,3736,3559,0.047376873648989064,177
غالبر,2019-05-18,4100,3736,0.08878048778322427,364
غالبر,2019-05-19,4090,4100,0.002444987774463328,10
غالبر,2019-05-20,3930,4090,0.04071246818302482,160
غالبر,2019-05-21,4118,3930,0.04565322971208032,188
غالبر,2019-05-22,4314,4118,0.045433472404860106,196
غالبر,2019-05-25,4524,4314,0.04641909813297544,210
غالبر,2019-05-26,4750,4524,0.04757894735840443,226
غالبر,2019-05-28,4987,4750,0.04752356124974462,237
غالبر,2019-05-29,5236,4987,0.047555385781597515,249
غالبر,2019-06-01,5376,5236,0.026041666661822605,140
غالبر,2019-06-02,5493,5376,0.021299836151228865,117
غالبر,2019-06-03,5767,5493,0.047511704517511404,274
غالبر,2019-06-08,6055,5767,0.047563996689089345,288
غالبر,2019-06-09,6295,6055,0.03812549641967824,240
غالبر,2019-06-11,6779,6295,0.07139696119318528,484
غالبر,2019-06-12,6973,6779,0.02782159758671711,194
غالبر,2019-06-15,6737,6973,0.0350304289691212,236
غالبر,2019-06-17,6083,6737,0.10751274040645853,654
غالبر,2019-06-18,5824,6083,0.044471153838518,259
غالبر,2019-06-19,5562,5824,0.047105357776500295,262
غالبر,2019-06-22,5840,5562,0.04760273971787624,278
غالبر,2019-06-23,6132,5840,0.04761904761128195,292
غالبر,2019-06-24,6438,6132,0.04753028890221648,306
غالبر,2019-06-25,6727,6438,0.042961201123389144,289
غالبر,2019-06-26,6668,6727,0.008848230352602245,59
غالبر,2019-06-30,6345,6668,0.05090622536628743,323
غالبر,2019-07-01,6458,6345,0.017497677296764064,113
غالبر,2019-07-02,6674,6458,0.032364399156073656,216
غالبر,2019-07-03,6983,6674,0.04425032220474719,309
غالبر,2019-07-06,7307,6983,0.044341042829568765,324
غالبر,2019-07-07,7672,7307,0.04757559957669765,365
غالبر,2019-07-08,8039,7672,0.0456524443281935,367
غالبر,2019-07-09,7690,8039,0.045383615078623714,349
غالبر,2019-07-10,8073,7690,0.04744209091447515,383
غالبر,2019-07-13,7750,8073,0.041677419349460974,323
غالبر,2019-07-14,7385,7750,0.0494245091334564,365
غالبر,2019-07-15,7088,7385,0.04190180586316283,297
غالبر,2019-07-16,6774,7088,0.04635370533711932,314
غالبر,2019-07-23,6495,6774,0.04295612008576503,279
غالبر,2019-07-24,6676,6495,0.027112043135543433,181
غالبر,2019-07-27,6742,6676,0.009789380004480958,66
غالبر,2019-07-28,6903,6742,0.023323192811339533,161
غالبر,2019-07-29,7243,6903,0.04694187490722879,340
غالبر,2019-07-30,7605,7243,0.047600262978619294,362
غالبر,2019-07-31,7985,7605,0.047589229799926205,380
غالبر,2019-08-03,8384,7985,0.04759064884928547,399
غالبر,2019-08-04,8739,8384,0.04062249684853845,355
غالبر,2019-08-05,8403,8739,0.03998571938117509,336
غالبر,2019-08-06,8679,8403,0.03180089871738669,276
غالبر,2019-08-07,8600,8679,0.009186046510559761,79
غالبر,2019-08-10,8418,8600,0.021620337369729112,182
غالبر,2019-08-11,8125,8418,0.03606153845710012,293
غالبر,2019-08-13,7731,8125,0.050963652819691674,394
غالبر,2019-08-14,8095,7731,0.044966028407045576,364
غالبر,2019-08-17,7792,8095,0.038886036955995115,303
غالبر,2019-08-18,7997,7792,0.02563461297666192,205
غالبر,2019-08-19,8088,7997,0.01125123639821325,91
غالبر,2019-08-21,8461,8088,0.044084623561743926,373
غالبر,2019-08-24,8869,8461,0.04600293155417714,408
غالبر,2019-08-25,8951,8869,0.009160987598127474,82
غالبر,2019-08-26,8887,8951,0.007201530324383759,64
غالبر,2019-08-27,8839,8887,0.005430478560308804,48
غالبر,2019-08-28,8542,8839,0.034769374849593845,297
غالبر,2019-08-31,8638,8542,0.011113683721797442,96
غالبر,2019-09-01,8878,8638,0.027033115563524092,240
غالبر,2019-09-02,8639,8878,0.027665239029093038,239
غالبر,2019-09-03,8494,8639,0.017070873555795753,145
غالبر,2019-09-04,8857,8494,0.04098453200395342,363
غالبر,2019-09-07,9299,8857,0.047531992682274225,442
غالبر,2019-09-08,9718,9299,0.04311586745800413,419
غالبر,2019-09-11,10124,9718,0.040102726191218616,406
غالبر,2019-09-14,10540,10124,0.03946869069834263,416
غالبر,2019-09-15,10797,10540,0.02380290821304039,257
غالبر,2019-09-16,11332,10797,0.047211436635438454,535
غالبر,2019-09-17,11824,11332,0.04161028416427518,492
غالبر,2019-09-18,11680,11824,0.012328767122232126,144
غالبر,2019-09-21,12187,11680,0.04160170673327302,507
غالبر,2019-09-22,12796,12187,0.047592997808096824,609
غالبر,2019-09-23,13434,12796,0.047491439627252385,638
غالبر,2019-09-28,14732,13434,0.0881075210366476,1298
غالبر,2019-09-29,14006,14732,0.05183492788434707,726
غالبر,2019-09-30,14575,14006,0.03903945111224429,569
غالبر,2019-10-01,14891,14575,0.021220871666025057,316
غالبر,2019-10-02,14192,14891,0.04925310033474823,699
غالبر,2019-10-05,13516,14192,0.05001479727360056,676
غالبر,2019-10-06,13997,13516,0.03436450667754772,481
غالبر,2019-10-07,13531,13997,0.03443943536808518,466
غالبر,2019-10-08,12938,13531,0.04583397742728134,593
غالبر,2019-10-09,12295,12938,0.05229768198029299,643
غالبر,2019-10-12,12603,12295,0.024438625722094848,308
غالبر,2019-10-13,12236,12603,0.029993461913207464,367
غالبر,2019-10-14,11663,12236,0.04912972648125442,573
غالبر,2019-10-15,11287,11663,0.033312660580020144,376
غالبر,2019-10-16,10754,11287,0.0495629533150862,533
غالبر,2019-10-20,10217,10754,0.05255945971884511,537
غالبر,2019-10-21,9857,10217,0.03652226843496781,360
غالبر,2019-10-22,10336,9857,0.0463428792524823,479
غالبر,2019-10-23,10495,10336,0.015150071461157686,159
غالبر,2019-10-26,10156,10495,0.0333792831790686,339
غالبر,2019-10-28,10587,10156,0.04071030508730421,431
غالبر,2019-10-30,11045,10587,0.041466727022049184,458
غالبر,2019-11-02,11252,11045,0.018396729468681414,207
غالبر,2019-11-03,10990,11252,0.02383985441093359,262
غالبر,2019-11-04,10441,10990,0.05258117038094232,549
غالبر,2019-11-05,9938,10441,0.0506138055895941,503
غالبر,2019-11-09,10264,9938,0.03176149648950102,326
غالبر,2019-11-10,9818,10264,0.04542676715772797,446
غالبر,2019-11-11,10090,9818,0.0269573835453957,272
غالبر,2019-11-12,10594,10090,0.047574098541856326,504
غالبر,2019-11-13,11051,10594,0.04135372364117693,457
غالبر,2019-11-16,11560,11051,0.04403114186470319,509
غالبر,2019-11-17,10982,11560,0.05263157894257589,578
غالبر,2019-11-18,11246,10982,0.02347501333598835,264
غالبر,2019-11-19,11801,11246,0.04702991271527583,555
غالبر,2019-11-20,12180,11801,0.031116584562305698,379
غالبر,2019-11-23,11672,12180,0.04352296092841647,508
غالبر,2019-11-24,11355,11672,0.027917217082526005,317
غالبر,2019-11-25,10974,11355,0.034718425365890426,381
غالبر,2019-11-26,11355,10974,0.033553500657547024,381
غالبر,2019-11-27,11644,11355,0.024819649602815214,289
غالبر,2019-11-30,11450,11644,0.016943231439568277,194
غالبر,2019-12-01,11394,11450,0.004914867473677824,56
غالبر,2019-12-02,11158,11394,0.021150743859011403,236
غالبر,2019-12-03,11675,11158,0.04428265524245973,517
غالبر,2019-12-04,12258,11675,0.047560776631786525,583
غالبر,2019-12-07,12870,12258,0.04755244754875272,612
غالبر,2019-12-08,13513,12870,0.04758380818118968,643
غالبر,2019-12-09,13616,13513,0.0075646298466829735,103
غالبر,2019-12-10,13603,13616,9.556715429717216e-4,13
غالبر,2019-12-11,13590,13603,9.565857247272563e-4,13
غالبر,2019-12-14,13624,13590,0.0024955960068632124,34
غالبر,2019-12-15,13034,13624,0.04526622678799553,590
غالبر,2019-12-16,12497,13034,0.04297031287165157,537
غالبر,2019-12-17,12955,12497,0.03535314550093762,458
غالبر,2019-12-18,13092,12955,0.010464405743166483,137
غالبر,2019-12-21,12658,13092,0.03428661715640017,434
غالبر,2019-12-22,12705,12658,0.0036993309717670733,47
غالبر,2019-12-23,12248,12705,0.037312214236013046,457
غالبر,2019-12-24,12080,12248,0.013907284767060655,168
غالبر,2019-12-25,12366,12080,0.023127931423004372,286
غالبر,2019-12-28,12676,12366,0.024455664245467367,310
غالبر,2019-12-29,12383,12676,0.023661471370131512,293
غالبر,2019-12-30,12427,12383,0.0035406775566475673,44
غالبر,2019-12-31,12038,12427,0.032314337927204326,389
غالبر,2020-01-01,12299,12038,0.021221237497258214,261
غالبر,2020-01-04,11685,12299,0.05254599913970509,614
غالبر,2020-01-05,11118,11685,0.05099838099919064,567
غالبر,2020-01-07,10748,11118,0.03442500930085365,370
غالبر,2020-01-08,10534,10748,0.02031516992402552,214
غالبر,2020-01-11,10744,10534,0.019545792998925372,210
غالبر,2020-01-12,11281,10744,0.04760216292459869,537
غالبر,2020-01-13,11792,11281,0.043334464039744364,511
غالبر,2020-01-14,11793,11792,8.479606545537217e-5,1
غالبر,2020-01-15,11377,11793,0.03656499955730289,416
غالبر,2020-01-18,11904,11377,0.044270833329614345,527
غالبر,2020-01-19,12103,11904,0.0164422044107707,199
غالبر,2020-01-20,12647,12103,0.04301415355080144,544
غالبر,2020-01-21,12865,12647,0.016945200154143397,218
غالبر,2020-01-22,12795,12865,0.005470887064832287,70
غالبر,2020-01-25,13396,12795,0.04486413854547147,601
غالبر,2020-01-26,13761,13396,0.02652423515540119,365
غالبر,2020-01-27,13247,13761,0.03880123801322554,514
غالبر,2020-01-28,13289,13247,0.003160508691161072,42
غالبر,2020-02-01,12853,13289,0.03392204154408138,436
غالبر,2020-02-02,13046,12853,0.014793806529603418,193
غالبر,2020-02-03,12932,13046,0.008815341787131507,114
غالبر,2020-02-04,12470,12932,0.03704891739879319,462
غالبر,2020-02-05,13066,12470,0.045614572168558506,596
غالبر,2020-02-08,13048,13066,0.0013795217656821335,18
غالبر,2020-02-09,13289,13048,0.018135299870709963,241
غالبر,2020-02-10,12806,13289,0.03771669529613332,483
غالبر,2020-02-12,13385,12806,0.04325737765832967,579
غالبر,2020-02-15,14054,13385,0.04760210615855969,669
غالبر,2020-02-16,14756,14054,0.047573868253756174,702
غالبر,2020-02-17,15456,14756,0.04528985506953352,700
غالبر,2020-02-18,15615,15456,0.010182516810106786,159
غالبر,2020-02-19,15645,15615,0.0019175455415840494,30
غالبر,2020-02-22,15272,15645,0.02442378208326193,373
غالبر,2020-02-23,16003,15272,0.04567893519679567,731
غالبر,2020-02-24,16543,16003,0.032642205160331124,540
غالبر,2020-02-25,16557,16543,8.455638098178677e-4,14
غالبر,2020-02-26,15865,16557,0.04361802710093804,692
غالبر,2020-02-29,15310,15865,0.036250816457462386,555
غالبر,2020-03-01,15953,15310,0.0403058985745436,643
غالبر,2020-03-02,16710,15953,0.045302214240257196,757
غالبر,2020-03-03,16656,16710,0.0032420749277592416,54
غالبر,2020-03-04,16518,16656,0.008354522338760472,138
غالبر,2020-03-07,15787,16518,0.04630392094468208,731
غالبر,2020-03-09,15375,15787,0.026796747965736795,412
غالبر,2020-03-10,14766,15375,0.04124339699029911,609
غالبر,2020-03-11,15463,14766,0.04507534113399241,697
غالبر,2020-03-14,15155,15463,0.020323325633762896,308
غالبر,2020-03-15,14464,15155,0.04777378318253776,691
غالبر,2020-03-16,15086,14464,0.04123027972681756,622
غالبر,2020-03-17,15356,15086,0.01758270382797716,270
غالبر,2020-03-18,16043,15356,0.04282241475766238,687
غالبر,2020-03-24,16560,16043,0.03121980676139977,517
غالبر,2020-03-25,16954,16560,0.02323935354351543,394
غالبر,2020-03-28,17424,16954,0.02697428833637659,470
غالبر,2020-03-29,17557,17424,0.007575326080334036,133
غالبر,2020-03-30,17927,17557,0.020639259216788126,370
غالبر,2020-04-04,18724,17927,0.04256569108937376,797
غالبر,2020-04-05,19556,18724,0.04254448762310572,832
غالبر,2020-04-06,19121,19556,0.022749856177880348,435
غالبر,2020-04-07,19893,19121,0.038807620769174704,772
غالبر,2020-04-08,20741,19893,0.0408852032187028,848
غالبر,2020-04-11,20297,20741,0.021875153962562194,444
غالبر,2020-04-12,19490,20297,0.04140584915128754,807
غالبر,2020-04-13,18625,19490,0.04644295301764065,865
غالبر,2020-04-14,18808,18625,0.009729902168772337,183
غالبر,2020-04-15,19211,18808,0.020977564935663027,403
غالبر,2020-04-18,20161,19211,0.047120678535433724,950
غالبر,2020-04-19,20464,20161,0.014806489444155272,303
غالبر,2020-04-20,20133,20464,0.01644066954669246,331
غالبر,2020-04-21,20080,20133,0.002639442230944251,53
غالبر,2020-04-22,20239,20080,0.007856119373098665,159
غالبر,2020-04-25,21223,20239,0.04636479291116408,984
غالبر,2020-04-26,21554,21223,0.015356778323496485,331
غالبر,2020-04-27,21366,21554,0.008799026490274312,188
غالبر,2020-04-28,20949,21366,0.019905484747725168,417
غالبر,2020-04-29,21800,20949,0.03903669724591575,851
غالبر,2020-05-02,22433,21800,0.02821735835473555,633
غالبر,2020-05-03,23554,22433,0.04759276555796923,1121
غالبر,2020-05-04,23150,23554,0.017451403886935144,404
غالبر,2020-05-05,22394,23150,0.03375904259918911,756
غالبر,2020-05-06,22741,22394,0.015258783693977452,347
غالبر,2020-05-09,23573,22741,0.03529461672102428,832
غالبر,2020-05-10,24614,23573,0.04229300397975571,1041
غالبر,2020-05-11,24722,24614,0.0043685785937881815,108
غالبر,2020-05-12,23594,24722,0.04780876493821273,1128
غالبر,2020-05-13,22995,23594,0.02604914111650145,599
غالبر,2020-05-16,22396,22995,0.02674584747156877,599
غالبر,2020-05-17,21310,22396,0.05096198967381689,1086
غالبر,2020-05-18,22073,21310,0.034567118197138265,763
غالبر,2020-05-19,22012,22073,0.0027712157004010896,61
غالبر,2020-05-20,20999,22012,0.048240392397340806,1013
غالبر,2020-05-23,20098,20999,0.044830331374025756,901
غالبر,2020-05-26,19557,20098,0.027662729456068787,541
غالبر,2020-05-27,18921,19557,0.03361344537637474,636
غالبر,2020-05-30,19341,18921,0.021715526600397314,420
غالبر,2020-05-31,19919,19341,0.029017520958430767,578
غالبر,2020-06-01,20116,19919,0.009793199442742434,197
غالبر,2020-06-02,20615,20116,0.024205675477845953,499
غالبر,2020-06-06,21546,20615,0.0432098765412044,931
غالبر,2020-06-07,22487,21546,0.041846400140443524,941
غالبر,2020-06-08,21876,22487,0.027930151763214017,611
غالبر,2020-06-09,21030,21876,0.04022824536185315,846
غالبر,2020-06-10,21549,21030,0.024084644297921728,519
غالبر,2020-06-13,22300,21549,0.033677130043332865,751
غالبر,2020-06-14,22440,22300,0.0062388591797576266,140
غالبر,2020-06-15,23390,22440,0.04061564771096128,950
غالبر,2020-06-16,24160,23390,0.03187086092583316,770
غالبر,2020-06-20,24690,24160,0.021466180639065767,530
غالبر,2020-06-21,25690,24690,0.03892565200315587,1000
غالبر,2020-06-22,26920,25690,0.04569093610528637,1230
غالبر,2020-06-23,28000,26920,0.03857142857005102,1080
غالبر,2020-07-14,21600,28000,0.29629629628257886,6400
غالبر,2020-07-15,21110,21600,0.02321174798563658,490
غالبر,2020-07-18,20920,21110,0.009082217972797216,190
غالبر,2020-07-19,20380,20920,0.026496565258758754,540
غالبر,2020-07-20,19760,20380,0.031376518217035604,620
غالبر,2020-07-21,18800,19760,0.05106382978451788,960
غالبر,2020-07-22,18180,18800,0.03410341033915823,620
غالبر,2020-07-25,18990,18180,0.04265402843377283,810
غالبر,2020-07-26,19780,18990,0.03993933265723259,790
غالبر,2020-07-27,19060,19780,0.03777544595814399,720
غالبر,2020-07-28,18380,19060,0.03699673558014163,680
غالبر,2020-07-29,18230,18380,0.008228195282050016,150
غالبر,2020-08-01,18870,18230,0.03391626920858949,640
غالبر,2020-08-02,19780,18870,0.04600606673174894,910
غالبر,2020-08-03,19080,19780,0.03668763102533083,700
غالبر,2020-08-04,18150,19080,0.05123966941866448,930
غالبر,2020-08-05,17620,18150,0.030079455162878577,530
غالبر,2020-08-09,17410,17620,0.012062033313494426,210
غالبر,2020-08-10,16790,17410,0.03692674210619853,620
غالبر,2020-08-11,15960,16790,0.05200501252806986,830
غالبر,2020-08-12,15760,15960,0.012690355329144013,200
غالبر,2020-08-15,15120,15760,0.04232804232524286,640
غالبر,2020-08-19,15160,15120,0.0026385224272665883,40
غالبر,2020-08-22,15020,15160,0.009320905458766918,140
غالبر,2020-08-23,14990,15020,0.0020013342226816986,30
غالبر,2020-08-24,14980,14990,6.675567422785342e-4,10
غالبر,2020-08-25,14650,14980,0.022525597268086988,330
غالبر,2020-08-26,15020,14650,0.024633821569598282,370
غالبر,2020-08-31,15440,15020,0.02720207253709831,420
غالبر,2020-09-01,16200,15440,0.04691358024401768,760
غالبر,2020-09-02,16050,16200,0.009345794391941073,150
غالبر,2020-09-05,15620,16050,0.027528809217187655,430
غالبر,2020-09-06,15410,15620,0.013627514600024171,210
غالبر,2020-09-07,15410,15410,0,0
غالبر,2020-09-08,15410,15410,0,0
غالبر,2020-09-09,15350,15410,0.0039087947880189705,60
وآذر,2018-01-15,5545,5572,0.0048692515771200625,27
وآذر,2018-01-16,5549,5545,7.208506035824741e-4,4
وآذر,2018-01-21,5549,5549,0,0
وآذر,2018-01-22,5506,5549,0.00780966218528702,43
وآذر,2018-01-24,5498,5506,0.001455074572307189,8
وآذر,2018-01-27,5472,5498,0.0047514619874357705,26
وآذر,2018-01-29,5456,5472,0.0029325513191106028,16
وآذر,2018-01-30,5353,5456,0.019241546792594516,103
وآذر,2018-01-31,5344,5353,0.0016841317362118015,9
وآذر,2018-02-03,5290,5344,0.010207939506576948,54
وآذر,2018-02-04,5276,5290,0.0026535253975258667,14
وآذر,2018-02-05,5249,5276,0.005143836920338381,27
وآذر,2018-02-06,5213,5249,0.006905812390771952,36
وآذر,2018-02-07,5260,5213,0.0089353612150313,47
وآذر,2018-02-10,5248,5260,0.0022865853654179522,12
وآذر,2018-02-12,5246,5248,3.812428516238576e-4,2
وآذر,2018-02-13,5245,5246,1.9065776926774873e-4,1
وآذر,2018-02-14,5233,5245,0.002293139689987934,12
وآذر,2018-02-24,5222,5233,0.0021064726154526093,11
وآذر,2018-02-25,5199,5222,0.004423927677548773,23
وآذر,2018-02-26,5197,5199,3.848374061218323e-4,2
وآذر,2018-02-27,5196,5197,1.9245573514386916e-4,1
وآذر,2018-03-05,4937,5196,0.052461008699116664,259
وآذر,2018-03-06,4934,4937,6.080259423169789e-4,3
وآذر,2018-03-17,4933,4934,2.0271639971564638e-4,1
وآذر,2018-03-28,4929,4933,8.115236354612449e-4,4
وآذر,2018-04-03,4928,4929,2.0292207788090053e-4,1
وآذر,2018-04-16,4815,4928,0.023468328136351333,113
وآذر,2018-04-23,4790,4815,0.005219206679494946,25
وآذر,2018-04-24,4766,4790,0.00503566932332445,24
وآذر,2018-04-25,4758,4766,0.001681378730205679,8
وآذر,2018-05-05,4735,4758,0.004857444560748163,23
وآذر,2018-05-07,4721,4735,0.00296547341602087,14
وآذر,2018-05-13,4632,4721,0.019214162344729238,89
وآذر,2018-05-14,4627,4632,0.0010806137883983976,5
وآذر,2018-05-15,4621,4627,0.0012984202550750008,6
وآذر,2018-05-19,4416,4621,0.04642210143876311,205
وآذر,2018-05-20,4421,4416,0.0011309658445756692,5
وآذر,2018-05-21,4293,4421,0.029815979494568837,128
وآذر,2018-05-22,4258,4293,0.008219821510516716,35
وآذر,2018-05-23,4254,4258,9.402914901409751e-4,4
وآذر,2018-05-26,4248,4254,0.0014124293781985805,6
وآذر,2018-05-27,4225,4248,0.00544378698096005,23
وآذر,2018-05-28,4224,4225,2.3674242418637726e-4,1
وآذر,2018-05-29,4220,4224,9.478672983535859e-4,4
وآذر,2018-06-02,4163,4220,0.013692048999833761,57
وآذر,2018-06-03,4155,4163,0.0019253910946027937,8
وآذر,2018-06-09,4155,4155,0,0
وآذر,2018-06-10,4141,4155,0.0033808258866503678,14
وآذر,2018-06-11,4141,4141,0,0
وآذر,2018-06-12,4139,4141,4.832085043529334e-4,2
وآذر,2018-06-13,4124,4139,0.003637245391940532,15
وآذر,2018-06-17,4075,4124,0.012024539874349807,49
وآذر,2018-06-18,4010,4075,0.01620947630518467,65
وآذر,2018-06-19,4009,4010,2.494387627215169e-4,1
وآذر,2018-06-20,4008,4009,2.495009979417413e-4,1
وآذر,2018-06-23,3999,4008,0.0022505626400973837,9
وآذر,2018-06-24,3998,3999,2.501250624687031e-4,1
وآذر,2018-06-25,3962,3998,0.009086320038090278,36
وآذر,2018-06-26,3951,3962,0.0027841052890953924,11
وآذر,2018-06-27,3948,3951,7.598784192604158e-4,3
وآذر,2018-06-30,3941,3948,0.0017761989338299419,7
وآذر,2018-07-01,3917,3941,0.006127138114340787,24
وآذر,2018-07-02,3911,3917,0.0015341344920649107,6
وآذر,2018-07-03,3867,3911,0.011378329451414966,44
وآذر,2018-07-04,3864,3867,7.763975153270193e-4,3
وآذر,2018-07-07,3855,3864,0.0023346303495889414,9
وآذر,2018-07-08,3829,3855,0.006790284667853151,26
وآذر,2018-07-10,3828,3829,2.612330197854668e-4,1
وآذر,2018-07-11,3826,3828,5.227391530259437e-4,2
وآذر,2018-07-14,3823,3826,7.847240385077886e-4,3
وآذر,2018-07-15,3790,3823,0.008707124008256696,33
وآذر,2018-07-16,3772,3790,0.004772004240516436,18
وآذر,2018-07-17,3762,3772,0.002658160552190813,10
وآذر,2018-07-21,3763,3762,2.6574541582095526e-4,1
وآذر,2018-07-22,3764,3763,2.656748139570471e-4,1
وآذر,2018-07-23,3748,3764,0.004268943435360474,16
وآذر,2018-07-24,3751,3748,7.997867233271697e-4,3
وآذر,2018-07-25,3715,3751,0.009690444142748198,36
وآذر,2018-07-28,3712,3715,8.081896549546903e-4,3
وآذر,2018-07-29,3710,3712,5.39083557806177e-4,2
وآذر,2018-07-30,3709,3710,2.696144512618996e-4,1
وآذر,2018-07-31,3675,3709,0.009251700677754639,34
وآذر,2018-08-01,3655,3675,0.00547195622285309,20
وآذر,2018-08-04,3650,3655,0.0013698630133233253,5
وآذر,2018-08-06,3650,3650,0,0
وآذر,2018-08-07,3644,3650,0.001646542260799522,6
وآذر,2018-08-11,3643,3644,2.744990391780129e-4,1
وآذر,2018-08-18,3552,3643,0.02561936936215671,91
وآذر,2018-08-19,3528,3552,0.0068027210865071654,24
وآذر,2018-08-20,3530,3528,5.665722377998379e-4,2
وآذر,2018-08-21,3520,3530,0.0028409090901020144,10
وآذر,2018-08-25,3549,3520,0.00817131586132113,29
وآذر,2018-08-26,3542,3549,0.00197628458442228,7
وآذر,2018-08-27,3553,3542,0.0030959752313267732,11
وآذر,2018-08-28,3592,3553,0.010857461021476209,39
وآذر,2018-08-29,3586,3592,0.0016731734518479718,6
وآذر,2018-09-01,3582,3586,0.0011166945837195158,4
وآذر,2018-09-02,3619,3582,0.010223818731631994,37
وآذر,2018-09-03,3621,3619,5.523336093476019e-4,2
وآذر,2018-09-04,3621,3621,0,0
وآذر,2018-09-05,3621,3621,0,0
وآذر,2018-09-08,3634,3621,0.0035773252604355188,13
وآذر,2018-09-09,3714,3634,0.02154011846485188,80
وآذر,2018-09-10,3772,3714,0.015376458108330738,58
وآذر,2018-09-11,3804,3772,0.008412197684434228,32
وآذر,2018-09-12,3880,3804,0.019587628860931024,76
وآذر,2018-09-15,3940,3880,0.015228426392074003,60
وآذر,2018-09-16,3971,3940,0.007806597832332764,31
وآذر,2018-09-17,4081,3971,0.02695417789096933,110
وآذر,2018-09-18,4109,4081,0.0068143100494489385,28
وآذر,2018-09-22,4190,4109,0.01933174223882297,81
وآذر,2018-09-23,4197,4190,0.001667857993407706,7
وآذر,2018-09-24,4236,4197,0.009206798864682057,39
وآذر,2018-09-25,4270,4236,0.007962529272139923,34
وآذر,2018-09-26,4483,4270,0.04751282622183519,213
وآذر,2018-09-29,4513,4483,0.006647462883525933,30
وآذر,2018-09-30,4567,4513,0.011823954453290134,54
وآذر,2018-10-01,4652,4567,0.018271711088075727,85
وآذر,2018-10-02,4586,4652,0.014391626686787696,66
وآذر,2018-10-03,4513,4586,0.01617549301657977,73
وآذر,2018-10-06,4487,4513,0.005794517493694112,26
وآذر,2018-10-07,4476,4487,0.002457551384616275,11
وآذر,2018-10-08,4472,4476,8.944543826264636e-4,4
وآذر,2018-10-09,4413,4472,0.013369589845146251,59
وآذر,2018-10-10,4396,4413,0.0038671519554442325,17
وآذر,2018-10-13,4379,4396,0.003882164876939446,17
وآذر,2018-10-15,4370,4379,0.00205949656703444,9
وآذر,2018-10-16,4355,4370,0.0034443168763618097,15
وآذر,2018-10-17,4338,4355,0.003918856615048673,17
وآذر,2018-10-20,4292,4338,0.010717614163392912,46
وآذر,2018-10-21,4261,4292,0.007275287489491835,31
وآذر,2018-10-22,4257,4261,9.396288463848652e-4,4
وآذر,2018-10-23,4240,4257,0.00400943396131853,17
وآذر,2018-10-24,4219,4240,0.004977482814653358,21
وآذر,2018-10-27,4204,4219,0.0035680304463444265,15
وآذر,2018-10-28,4177,4204,0.006463969354449612,27
وآذر,2018-10-29,4112,4177,0.01580739299226474,65
وآذر,2018-10-31,4205,4112,0.022116527937665508,93
وآذر,2018-11-03,4398,4205,0.043883583437043294,193
وآذر,2018-11-04,4580,4398,0.039737991257699126,182
وآذر,2018-11-05,4743,4580,0.03436643473869567,163
وآذر,2018-11-06,4812,4743,0.014339152116720873,69
وآذر,2018-11-10,5036,4812,0.04447974582119147,224
وآذر,2018-11-11,4977,5036,0.01185453083949075,59
وآذر,2018-11-12,4978,4977,2.0088388907173887e-4,1
وآذر,2018-11-13,4947,4978,0.006266424094144648,31
وآذر,2018-11-14,4943,4947,8.092251667389793e-4,4
وآذر,2018-11-19,4942,4943,2.0234722780203415e-4,1
وآذر,2018-12-01,4942,4942,0,0
وآذر,2018-12-02,4938,4942,8.100445522863417e-4,4
وآذر,2018-12-05,4937,4938,2.0255215713944658e-4,1
وآذر,2018-12-09,4936,4937,2.0259319282767558e-4,1
وآذر,2018-12-10,4935,4936,2.0263424514637603e-4,1
وآذر,2018-12-12,4932,4935,6.082725059593932e-4,3
وآذر,2018-12-23,4931,4932,2.027986209282501e-4,1
وآذر,2019-01-05,4930,4931,2.028397565511481e-4,1
وآذر,2019-01-06,4684,4930,0.052519214335499734,246
وآذر,2019-01-07,4665,4684,0.004072883171688556,19
وآذر,2019-01-08,4661,4665,8.581849386702027e-4,4
وآذر,2019-01-13,4649,4661,0.0025812002575648094,12
وآذر,2019-01-14,4635,4649,0.003020496223728048,14
وآذر,2019-01-16,4617,4635,0.003898635476738437,18
وآذر,2019-01-22,4470,4617,0.03288590603291143,147
وآذر,2019-01-23,4270,4470,0.04683840748317601,200
وآذر,2019-01-26,4263,4270,0.0016420361244095622,7
وآذر,2019-01-27,4288,4263,0.005830223879237354,25
وآذر,2019-01-28,4251,4288,0.008703834389860306,37
وآذر,2019-01-29,4243,4251,0.001885458401629635,8
وآذر,2019-01-30,4125,4243,0.0286060605991258,118
وآذر,2019-02-02,4121,4125,9.706381943774233e-4,4
وآذر,2019-02-03,4091,4121,0.007333170372199176,30
وآذر,2019-02-04,4032,4091,0.014632936504307309,59
وآذر,2019-02-05,4198,4032,0.039542639342653015,166
وآذر,2019-02-06,4404,4198,0.046775658481658565,206
وآذر,2019-02-10,4400,4404,9.090909088842975e-4,4
وآذر,2019-02-12,4352,4400,0.01102941176217155,48
وآذر,2019-02-13,4185,4352,0.03990442054004673,167
وآذر,2019-02-16,4221,4185,0.008528784646167072,36
وآذر,2019-02-17,4226,4221,0.0011831519164261352,5
وآذر,2019-02-18,4210,4226,0.003800475058479697,16
وآذر,2019-02-19,4209,4210,2.3758612491385454e-4,1
وآذر,2019-02-20,4214,4209,0.0011865211197943709,5
وآذر,2019-02-23,4201,4214,0.0030945013084754816,13
وآذر,2019-02-24,4188,4201,0.0031041069715606238,13
وآذر,2019-02-25,4186,4188,4.777830863646003e-4,2
وآذر,2019-02-26,4286,4186,0.023331777876030847,100
وآذر,2019-02-27,4279,4286,0.0016358962370563457,7
وآذر,2019-03-02,4276,4279,7.015902711174952e-4,3
وآذر,2019-03-03,4270,4276,0.0014051522244952804,6
وآذر,2019-03-04,4263,4270,0.0016420361244095622,7
وآذر,2019-03-05,4226,4263,0.008755324181553401,37
وآذر,2019-03-06,4188,4226,0.009073543455331054,38
وآذر,2019-03-09,4159,4188,0.0069728300055367076,29
وآذر,2019-03-10,3961,4159,0.049987376912399045,198
وآذر,2019-03-11,4086,3961,0.030592266267598565,125
وآذر,2019-03-12,4138,4086,0.012566457222676061,52
وآذر,2019-03-13,4154,4138,0.003851709195028476,16
وآذر,2019-03-16,4146,4154,0.0019295706700604024,8
وآذر,2019-03-17,4134,4146,0.0029027576190365847,12
وآذر,2019-03-18,4117,4134,0.004129220305045125,17
وآذر,2019-03-19,4152,4117,0.00842967244498322,35
وآذر,2019-03-25,4223,4152,0.016812692394787426,71
وآذر,2019-03-26,4293,4223,0.01630561378609233,70
وآذر,2019-03-27,4418,4293,0.028293345398756598,125
وآذر,2019-03-30,4638,4418,0.047434238885848586,220
وآذر,2019-03-31,4785,4638,0.030721003128375963,147
وآذر,2019-04-06,4979,4785,0.038963647310913105,194
وآذر,2019-04-07,4896,4979,0.016952614375622423,83
وآذر,2019-04-08,4905,4896,0.0018348623849470207,9
وآذر,2019-04-09,4885,4905,0.004094165812877346,20
وآذر,2019-04-10,4950,4885,0.01313131312866034,65
وآذر,2019-04-13,4976,4950,0.005225080384802033,26
وآذر,2019-04-14,4904,4976,0.014681892329795698,72
وآذر,2019-04-15,4983,4904,0.015853903267940214,79
وآذر,2019-04-16,4994,4983,0.0022026431713651094,11
وآذر,2019-04-17,5153,4994,0.030855812142275212,159
وآذر,2019-04-20,5304,5153,0.0284690799343007,151
وآذر,2019-04-24,5555,5304,0.04518451844371116,251
وآذر,2019-04-27,5693,5555,0.024240295094986774,138
وآذر,2019-04-28,5793,5693,0.01726221301272877,100
وآذر,2019-04-29,6001,5793,0.03466088984591553,208
وآذر,2019-04-30,6001,6001,0,0
وآذر,2019-05-01,6067,6001,0.010878523156275173,66
وآذر,2019-05-04,6075,6067,0.0013168724277667699,8
وآذر,2019-05-05,6093,6075,0.002954209748407318,18
وآذر,2019-05-06,5820,6093,0.0469072164867857,273
وآذر,2019-05-07,5698,5820,0.02141102140726377,122
وآذر,2019-05-08,5648,5698,0.008852691216562908,50
وآذر,2019-05-11,5646,5648,3.54233085307433e-4,2
وآذر,2019-05-12,5798,5646,0.026215936525316324,152
وآذر,2019-05-13,5996,5798,0.03302201467094362,198
وآذر,2019-05-14,6158,5996,0.02630724260696537,162
وآذر,2019-05-15,6357,6158,0.03130407424393518,199
وآذر,2019-05-18,6520,6357,0.02499999999616564,163
وآذر,2019-05-19,6652,6520,0.019843656040312137,132
وآذر,2019-05-20,6983,6652,0.04740083058178421,331
وآذر,2019-05-21,6894,6983,0.012909776615475807,89
وآذر,2019-05-28,6856,6894,0.0055425904309301935,38
وآذر,2019-05-29,7198,6856,0.04751319810398538,342
وآذر,2019-06-01,7504,7198,0.04077825159371292,306
وآذر,2019-06-02,7876,7504,0.04723209750543015,372
وآذر,2019-06-03,7820,7876,0.007161125318777349,56
وآذر,2019-06-08,8065,7820,0.030378177305594768,245
وآذر,2019-06-09,8385,8065,0.038163386996044914,320
وآذر,2019-06-18,4927,8385,0.7018469655567593,3458
وآذر,2019-06-19,5099,4927,0.033732104327567736,172
وآذر,2019-06-22,5120,5099,0.0041015624991989135,21
وآذر,2019-06-23,5244,5120,0.023646071696482442,124
وآذر,2019-06-24,5270,5244,0.004933586336824746,26
وآذر,2019-06-25,5297,5270,0.005097224843289177,27
وآذر,2019-06-26,5325,5297,0.005258215961453856,28
وآذر,2019-06-30,5437,5325,0.02059959536130226,112
وآذر,2019-07-01,5469,5437,0.005851161088708875,32
وآذر,2019-07-02,5620,5469,0.02686832739735439,151
وآذر,2019-07-03,5823,5620,0.034861755103063406,203
وآذر,2019-07-06,6426,5823,0.09383753499940281,603
وآذر,2019-07-07,6602,6426,0.02665858830253581,176
وآذر,2019-07-08,6709,6602,0.01594872559011049,107
وآذر,2019-07-09,6744,6709,0.005189798338494988,35
وآذر,2019-07-10,7070,6744,0.04611032531172414,326
وآذر,2019-07-13,7182,7070,0.015594541908160047,112
وآذر,2019-07-14,7234,7182,0.007188277577109721,52
وآذر,2019-07-15,7551,7234,0.04198119453820935,317
وآذر,2019-07-16,7927,7551,0.047432824517795784,376
وآذر,2019-07-17,8318,7927,0.04700649193952795,391
وآذر,2019-07-20,8483,8318,0.01945066603566537,165
وآذر,2019-07-21,8531,8483,0.0056265385059633645,48
وآذر,2019-07-22,8794,8531,0.029906754602011965,263
وآذر,2019-07-23,8919,8794,0.014015024104270093,125
وآذر,2019-07-24,9036,8919,0.012948207169881782,117
وآذر,2019-07-27,9235,9036,0.02154845695489459,199
وآذر,2019-07-28,9313,9235,0.008375389239946806,78
وآذر,2019-07-29,9577,9313,0.027566043643357414,264
وآذر,2019-07-30,9722,9577,0.014914626618502918,145
وآذر,2019-07-31,13063,9722,0.2557605450313281,3341
وآذر,2019-08-03,13716,13063,0.047608632250830514,653
وآذر,2019-08-04,14048,13716,0.023633257401506742,332
وآذر,2019-08-05,14385,14048,0.023427181089786083,337
وآذر,2019-08-06,14511,14385,0.008683068016767758,126
وآذر,2019-08-07,15236,14511,0.047584667888711955,725
وآذر,2019-08-10,15463,15236,0.014680204357842579,227
وآذر,2019-08-11,15549,15463,0.005530902308474442,86
وآذر,2019-08-13,16095,15549,0.03392357874905725,546
وآذر,2019-08-14,16092,16095,1.8642803876544692e-4,3
وآذر,2019-08-17,15832,16092,0.016422435572484687,260
وآذر,2019-08-18,15517,15832,0.02030031578138169,315
وآذر,2019-08-19,14742,15517,0.052570885900653175,775
وآذر,2019-08-21,14312,14742,0.030044717717297043,430
وآذر,2019-08-24,13597,14312,0.05258512906872213,715
وآذر,2019-08-25,13910,13597,0.022501797266534736,313
وآذر,2019-08-26,14326,13910,0.029038112520659073,416
وآذر,2019-08-27,13675,14326,0.047605118826500536,651
وآذر,2019-08-28,13141,13675,0.04063617684798446,534
وآذر,2019-08-31,12776,13141,0.028569192233205292,365
وآذر,2019-09-01,13254,12776,0.03606458427372381,478
وآذر,2019-09-02,13647,13254,0.028797537918311897,393
وآذر,2019-09-03,13478,13647,0.012538952365889675,169
وآذر,2019-09-04,13279,13478,0.014986068226900665,199
وآذر,2019-09-07,13587,13279,0.022668727458403714,308
وآذر,2019-09-08,13696,13587,0.007958528036802094,109
وآذر,2019-09-11,13433,13696,0.019578649592825233,263
وآذر,2019-09-14,13150,13433,0.021520912545891946,283
وآذر,2019-09-15,13012,13150,0.010605594834721364,138
وآذر,2019-09-16,13662,13012,0.04757722148678252,650
وآذر,2019-09-17,13777,13662,0.008347245408409143,115
وآذر,2019-09-18,13273,13777,0.03797182249393718,504
وآذر,2019-09-21,13657,13273,0.028117448925231204,384
وآذر,2019-09-22,14281,13657,0.04369441915526263,624
وآذر,2019-09-23,14933,14281,0.04366168887406002,652
وآذر,2019-09-24,14559,14933,0.025688577510427323,374
وآذر,2019-09-25,13862,14559,0.0502813446796796,697
وآذر,2019-09-28,13808,13862,0.003910776361246322,54
وآذر,2019-09-29,13711,13808,0.00707461162518601,97
وآذر,2019-09-30,14030,13711,0.02273699215803728,319
وآذر,2019-10-01,14277,14030,0.017300553336324118,247
وآذر,2019-10-02,13716,14277,0.040901137354848266,561
وآذر,2019-10-05,13428,13716,0.021447721178027426,288
وآذر,2019-10-06,13053,13428,0.02872902780749797,375
وآذر,2019-10-07,12861,13053,0.014928854675769468,192
وآذر,2019-10-08,12279,12861,0.04739799657566593,582
وآذر,2019-10-09,11946,12279,0.02787543947531597,333
وآذر,2019-10-12,12313,11946,0.02980589620483993,367
وآذر,2019-10-13,12093,12313,0.0181923426760777,220
وآذر,2019-10-14,11498,12093,0.05174813010508365,595
وآذر,2019-10-15,10951,11498,0.049949776271577956,547
وآذر,2019-10-16,10601,10951,0.03301575322771288,350
وآذر,2019-10-20,10489,10601,0.010677852987827452,112
وآذر,2019-10-21,9972,10489,0.05184516646090602,517
وآذر,2019-10-22,10225,9972,0.0247432762811987,253
وآذر,2019-10-23,9820,10225,0.041242362521258416,405
وآذر,2019-10-26,9575,9820,0.02558746736025196,245
وآذر,2019-10-28,9437,9575,0.014623291298651765,138
وآذر,2019-10-30,9764,9437,0.03349037279460361,327
وآذر,2019-11-02,10016,9764,0.02515974440643373,252
وآذر,2019-11-03,9993,10016,0.00230161112755913,23
وآذر,2019-11-04,10492,9993,0.04756004574460922,499
وآذر,2019-11-05,11016,10492,0.0475671750138374,524
وآذر,2019-11-09,11566,11016,0.0475531730894386,550
وآذر,2019-11-10,11377,11566,0.016612463741178477,189
وآذر,2019-11-11,11060,11377,0.028661844482037808,317
وآذر,2019-11-12,10782,11060,0.02578371359434393,278
وآذر,2019-11-13,10932,10782,0.013721185509172961,150
وآذر,2019-11-16,11478,10932,0.04756926293364965,546
وآذر,2019-11-17,11225,11478,0.02253897549910566,253
وآذر,2019-11-18,11685,11225,0.039366709453199256,460
وآذر,2019-11-19,11348,11685,0.029696862880710533,337
وآذر,2019-11-20,11493,11348,0.012616375183797409,145
وآذر,2019-11-23,12027,11493,0.04440009977181341,534
وآذر,2019-11-24,12293,12027,0.02163833075558136,266
وآذر,2019-11-25,12390,12293,0.007828894268940364,97
وآذر,2019-11-26,12365,12390,0.0020218358267673404,25
وآذر,2019-11-27,12311,12365,0.004386321175827608,54
وآذر,2019-11-30,12283,12311,0.0022795733939363697,28
وآذر,2019-12-01,12597,12283,0.024926569816231915,314
وآذر,2019-12-02,13210,12597,0.04640423920920483,613
وآذر,2019-12-03,13830,13210,0.04483007953399638,620
وآذر,2019-12-04,14499,13830,0.04614111317703696,669
وآذر,2019-12-07,14470,14499,0.002004146509882229,29
وآذر,2019-12-08,15166,14470,0.04589212712344111,696
وآذر,2019-12-09,15824,15166,0.041582406468555204,658
وآذر,2019-12-10,15173,15824,0.04290516047960818,651
وآذر,2019-12-11,15674,15173,0.03196376164144674,501
وآذر,2019-12-14,15258,15674,0.02726438589413656,416
وآذر,2019-12-15,15333,15258,0.004891410682521919,75
وآذر,2019-12-16,14907,15333,0.028577178504824767,426
وآذر,2019-12-17,14309,14907,0.041791879233923274,598
وآذر,2019-12-18,13727,14309,0.042398193338500895,582
وآذر,2019-12-21,14403,13727,0.04693466638568807,676
وآذر,2019-12-22,15123,14403,0.04760960126644121,720
وآذر,2019-12-23,15859,15123,0.04640897912564418,736
وآذر,2019-12-24,16649,15859,0.047450297312304025,790
وآذر,2019-12-25,17453,16649,0.04606657880902615,804
وآذر,2019-12-28,17068,17453,0.022556831496217667,385
وآذر,2019-12-29,17267,17068,0.011524874036513299,199
وآذر,2019-12-30,18130,17267,0.04760066188375065,863
وآذر,2019-12-31,17745,18130,0.021696252464260567,385
وآذر,2020-01-01,17918,17745,0.009655095434219494,173
وآذر,2020-01-04,17023,17918,0.052575926684334376,895
وآذر,2020-01-05,16246,17023,0.04782715745119862,777
وآذر,2020-01-07,16223,16246,0.0014177402452433124,23
وآذر,2020-01-08,16035,16223,0.011724352977129756,188
وآذر,2020-01-11,16355,16035,0.019565881992077903,320
وآذر,2020-01-12,17172,16355,0.047577451662731335,817
وآذر,2020-01-13,18030,17172,0.04758735440667846,858
وآذر,2020-01-14,18915,18030,0.04678826328063504,885
وآذر,2020-01-15,19807,18915,0.045034583730750005,892
وآذر,2020-01-18,20208,19807,0.01984362628563719,401
وآذر,2020-01-26,19811,20208,0.020039372065012398,397
وآذر,2020-01-27,19060,19811,0.03940188877023075,751
وآذر,2020-01-28,19843,19060,0.039459759107017094,783
وآذر,2020-02-01,20761,19843,0.044217523238561846,918
وآذر,2020-02-02,19854,20761,0.04568348947085305,907
وآذر,2020-02-03,19561,19854,0.014978784314964532,293
وآذر,2020-02-04,20535,19561,0.04743121499647279,974
وآذر,2020-02-05,21561,20535,0.04758591901824656,1026
وآذر,2020-02-08,22515,21561,0.04237175216334125,954
وآذر,2020-02-09,21554,22515,0.04458569174888254,961
وآذر,2020-02-10,21780,21554,0.01037649219419759,226
وآذر,2020-02-12,22845,21780,0.0466185160846304,1065
وآذر,2020-02-15,23967,22845,0.04681436975646454,1122
وآذر,2020-02-16,25089,23967,0.044720793971672015,1122
وآذر,2020-02-17,25226,25089,0.005430904621999885,137
وآذر,2020-02-18,25746,25226,0.020197312203053007,520
وآذر,2020-02-19,26871,25746,0.041866696436981626,1125
وآذر,2020-02-22,27756,26871,0.03188499783715647,885
وآذر,2020-02-23,28959,27756,0.04154148969088914,1203
وآذر,2020-02-24,27913,28959,0.037473578617938826,1046
وآذر,2020-02-25,29107,27913,0.04102106022465314,1194
وآذر,2020-02-26,30560,29107,0.04754581151676879,1453
وآذر,2020-02-29,30995,30560,0.014034521696595111,435
وآذر,2020-03-01,32540,30995,0.04748002458366687,1545
وآذر,2020-03-04,35752,32540,0.08984112776656296,3212
وآذر,2020-03-07,37062,35752,0.035346176675966054,1310
وآذر,2020-03-09,36556,37062,0.013841776999293091,506
وآذر,2020-03-10,34767,36556,0.05145684125603426,1789
وآذر,2020-03-11,33139,34767,0.04912640695105083,1628
وآذر,2020-03-14,31858,33139,0.04020968045576591,1281
وآذر,2020-03-15,32251,31858,0.012185668661059017,393
وآذر,2020-03-16,32547,32251,0.009094540203118735,296
وآذر,2020-03-17,33577,32547,0.030675760192075654,1030
وآذر,2020-03-18,33754,33577,0.0052438229541611715,177
وآذر,2020-03-24,33893,33754,0.0041011418285751885,139
وآذر,2020-03-25,34098,33893,0.006012082819930434,205
وآذر,2020-03-28,34450,34098,0.01021770682118381,352
وآذر,2020-03-29,36172,34450,0.047605883002111965,1722
وآذر,2020-03-30,36965,36172,0.021452725550616725,793
وآذر,2020-04-04,37339,36965,0.01001633680575226,374
وآذر,2020-04-05,38059,37339,0.018917995742953886,720
وآذر,2020-04-06,38455,38059,0.010297750617337205,396
وآذر,2020-04-07,38764,38455,0.007971313589723163,309
وآذر,2020-04-08,39298,38764,0.013588477784783233,534
وآذر,2020-04-14,39790,39298,0.012364915807681204,492
وآذر,2020-04-15,40103,39790,0.0078049023761861975,313
وآذر,2020-04-18,40420,40103,0.007842652152205773,317
وآذر,2020-04-19,41366,40420,0.022869022868470024,946
وآذر,2020-04-20,41972,41366,0.014438196892822877,606
وآذر,2020-04-21,42413,41972,0.010397755404937219,441
وآذر,2020-04-22,42678,42413,0.006209288157687584,265
وآذر,2020-04-25,44022,42678,0.03053018945003566,1344
وآذر,2020-04-26,45143,44022,0.024832199897551508,1121
وآذر,2020-04-27,46482,45143,0.02880684996280696,1339
وآذر,2020-04-28,47917,46482,0.02994761775507758,1435
وآذر,2020-04-29,50203,47917,0.04553512738191871,2286
وآذر,2020-05-02,52652,50203,0.04651295297336259,2449
وآذر,2020-05-03,55006,52652,0.04279533141761271,2354
وآذر,2020-05-04,57756,55006,0.047614100698670024,2750
وآذر,2020-05-05,60311,57756,0.04236374790598127,2555
وآذر,2020-05-09,63326,60311,0.047610775983835854,3015
وآذر,2020-05-10,66492,63326,0.04761475064597825,3166
وآذر,2020-05-11,69816,66492,0.04761086283878179,3324
وآذر,2020-05-12,72132,69816,0.0321078023618906,2316
وآذر,2020-05-13,75738,72132,0.04761150281169808,3606
وآذر,2020-05-16,79524,75738,0.04760826920115176,3786
وآذر,2020-05-17,83500,79524,0.04761676646649561,3976
وآذر,2020-05-18,87675,83500,0.04761904761850449,4175
وآذر,2020-05-19,92058,87675,0.04761128853497131,4383
وآذر,2020-05-20,95009,92058,0.031060215347692745,2951
وآذر,2020-05-31,114100,95009,0.16731814197925227,19091
وآذر,2020-06-01,119805,114100,0.04761904761865015,5705
وآذر,2020-06-02,125795,119805,0.04761715489449011,5990
وآذر,2020-06-06,128890,125795,0.024012724028054832,3095
وآذر,2020-06-07,134001,128890,0.03814150640638397,5111
وآذر,2020-06-08,130141,134001,0.029660137850257336,3860
وآذر,2020-06-09,127177,130141,0.0233061009457425,2964
وآذر,2020-06-10,122589,127177,0.037425870183805846,4588
وآذر,2020-06-13,119760,122589,0.02362224448878071,2829
وآذر,2020-06-14,114240,119760,0.04831932773066948,5520
وآذر,2020-06-15,119540,114240,0.044336623723905504,5300
وآذر,2020-06-16,125510,119540,0.04756593100113485,5970
وآذر,2020-06-20,131780,125510,0.04757929883102459,6270
وآذر,2020-06-21,138320,131780,0.047281665702376505,6540
وآذر,2020-06-22,135140,138320,0.023531152878322248,3180
وآذر,2020-06-23,141590,135140,0.04555406455225966,6450
وآذر,2020-06-24,144520,141590,0.020274010517435135,2930
وآذر,2020-06-27,138950,144520,0.04008636200043118,5570
وآذر,2020-06-28,136620,138950,0.017054604011000916,2330
وآذر,2020-06-29,130710,136620,0.04521459719956228,5910
وآذر,2020-07-04,135050,130710,0.03213624583463801,4340
وآذر,2020-07-05,128300,135050,0.052611067809410675,6750
وآذر,2020-07-06,126580,128300,0.013588244588295243,1720
وآذر,2020-07-07,132900,126580,0.04755455229460079,6320
وآذر,2020-07-08,138660,132900,0.041540458675598295,5760
وآذر,2020-07-11,143660,138660,0.03480439927582622,5000
وآذر,2020-07-12,150260,143660,0.04392386529985409,6600
وآذر,2020-07-13,157770,150260,0.04760093807411041,7510
وآذر,2020-07-14,165650,157770,0.047570178086039416,7880
وآذر,2020-07-15,173930,165650,0.047605358477274734,8280
وآذر,2020-07-18,167540,173930,0.03814014563663519,6390
وآذر,2020-07-19,169920,167540,0.01400659133701738,2380
وآذر,2020-07-20,169560,169920,0.002123142250518264,360
وآذر,2020-07-21,161250,169560,0.05153488372061064,8310
وآذر,2020-07-22,154110,161250,0.04633054311825105,7140
وآذر,2020-07-25,150470,154110,0.02419086861152262,3640
وآذر,2020-07-26,147790,150470,0.018133838554583302,2680
وآذر,2020-07-27,141160,147790,0.04696797959728699,6630
وآذر,2020-07-28,142980,141160,0.012729053014318582,1820
وآذر,2020-07-29,146430,142980,0.02356074574866106,3450
وآذر,2020-08-01,153750,146430,0.047609756097251314,7320
وآذر,2020-08-02,161430,153750,0.04757480022271217,7680
وآذر,2020-08-03,169500,161430,0.04761061946874566,8070
وآذر,2020-08-04,177970,169500,0.04759229083526666,8470
وآذر,2020-08-05,186860,177970,0.047575725141562795,8890
وآذر,2020-08-09,178150,186860,0.04889138366517602,8710
وآذر,2020-08-10,175150,178150,0.01712817584917426,3000
وآذر,2020-08-11,167130,175150,0.04798659725933114,8020
وآذر,2020-08-12,172200,167130,0.029442508710630415,5070
وآذر,2020-08-15,167260,172200,0.029534855912773317,4940
وآذر,2020-08-16,160390,167260,0.04283309433229732,6870
وآذر,2020-08-17,153460,160390,0.045158347451810514,6930
وآذر,2020-08-18,160150,153460,0.04177333749583657,6690
وآذر,2020-08-19,157320,160150,0.017988812611123894,2830
وآذر,2020-08-22,153260,157320,0.02649093044482258,4060
وآذر,2020-08-23,151860,153260,0.009219017516072573,1400
وآذر,2020-08-24,151160,151860,0.004630854723441182,700
وآذر,2020-08-25,148070,151160,0.02086850813790188,3090
وآذر,2020-08-26,155100,148070,0.04532559638913394,7030
وآذر,2020-08-31,148480,155100,0.04458512931004455,6620
وآذر,2020-09-01,147140,148480,0.009106972950869192,1340
وآذر,2020-09-02,146520,147140,0.0042315042314753516,620
وآذر,2020-09-05,139960,146520,0.04687053443807609,6560
وآذر,2020-09-06,134670,139960,0.039281205910453094,5290
وآذر,2020-09-07,134410,134670,0.0019343798824348307,260
وآذر,2020-09-08,134370,134410,2.9768549527202734e-4,40
وآذر,2020-09-09,133480,134370,0.0066676655678253845,890
دپارس,2018-01-15,8241,8247,7.280669820740119e-4,6
دپارس,2018-01-16,8245,8241,4.851425105536516e-4,4
دپارس,2018-01-17,8384,8245,0.01657919847130496,139
دپارس,2018-01-20,8590,8384,0.023981373687545823,206
دپارس,2018-01-21,8722,8590,0.015134143543323304,132
دپارس,2018-01-22,9158,8722,0.047608648171259156,436
دپارس,2018-01-23,9600,9158,0.04604166666187066,442
دپارس,2018-01-24,9708,9600,0.011124845487111162,108
دپارس,2018-01-27,9493,9708,0.02264826714182574,215
دپارس,2018-01-28,9470,9493,0.0024287222806305465,23
دپارس,2018-01-29,9442,9470,0.0029654734163349424,28
دپارس,2018-01-30,9294,9442,0.015924252204010732,148
دپارس,2018-01-31,8927,9294,0.04111123557285636,367
دپارس,2018-02-03,8532,8927,0.0462962962908701,395
دپارس,2018-02-04,8568,8532,0.004201680671778515,36
دپارس,2018-02-05,8573,8568,5.832264084237458e-4,5
دپارس,2018-02-06,8608,8573,0.004065985129639175,35
دپارس,2018-02-07,8627,8608,0.0022023878518369782,19
دپارس,2018-02-10,8657,8627,0.0034654037191330245,30
دپارس,2018-02-12,8659,8657,2.3097355350144662e-4,2
دپارس,2018-02-13,8657,8659,2.310269146088683e-4,2
دپارس,2018-02-14,8629,8657,0.003244871943070475,28
دپارس,2018-02-17,8611,8629,0.0020903495526547033,18
دپارس,2018-02-18,8609,8611,2.3231501913900394e-4,2
دپارس,2018-02-19,8597,8609,0.0013958357564969365,12
دپارس,2018-02-21,8552,8597,0.0052619270339965005,45
دپارس,2018-02-24,8443,8552,0.012910103042412637,109
دپارس,2018-02-25,8440,8443,3.5545023692470966e-4,3
دپارس,2018-02-26,8439,8440,1.184974522907338e-4,1
دپارس,2018-02-27,8437,8439,2.37051084480615e-4,2
دپارس,2018-02-28,8442,8437,5.922767116095384e-4,5
دپارس,2018-03-03,8404,8442,0.00452165635357905,38
دپارس,2018-03-04,8404,8404,0,0
دپارس,2018-03-05,8392,8404,0.0014299332696103512,12
دپارس,2018-03-06,8386,8392,7.154781778302554e-4,6
دپارس,2018-03-07,8384,8386,2.3854961829215772e-4,2
دپارس,2018-03-10,8527,8384,0.016770259174766006,143
دپارس,2018-03-11,8521,8527,7.041427061724982e-4,6
دپارس,2018-03-12,8614,8521,0.010796377988066359,93
دپارس,2018-03-13,8934,8614,0.0358182225166982,320
دپارس,2018-03-14,9094,8934,0.0175940180319338,160
دپارس,2018-03-17,9308,9094,0.02299097550247196,214
دپارس,2018-03-18,9504,9308,0.020622895620725706,196
دپارس,2018-03-19,9676,9504,0.017775940469432,172
دپارس,2018-03-25,9692,9676,0.0016508460584347042,16
دپارس,2018-03-26,9843,9692,0.015340851364894763,151
دپارس,2018-03-27,9843,9843,0,0
دپارس,2018-03-28,9831,9843,0.0012206286236170654,12
دپارس,2018-04-03,9821,9831,0.0010182262497690432,10
دپارس,2018-04-07,9804,9821,0.0017339861279341098,17
دپارس,2018-04-08,9631,9804,0.01796282836486732,173
دپارس,2018-04-09,9560,9631,0.007426778241900965,71
دپارس,2018-04-10,9462,9560,0.010357218345977888,98
دپارس,2018-04-11,9417,9462,0.004778591907743592,45
دپارس,2018-04-15,9325,9417,0.009865951741569335,92
دپارس,2018-04-16,9222,9325,0.011168943828760687,103
دپارس,2018-04-17,9165,9222,0.006219312601612731,57
دپارس,2018-04-18,9084,9165,0.008916776749348659,81
دپارس,2018-04-21,9034,9084,0.005534646888915802,50
دپارس,2018-04-22,9011,9034,0.0025524359113802647,23
دپارس,2018-04-23,8949,9011,0.006928148395694698,62
دپارس,2018-04-24,9348,8949,0.042682926824702296,399
دپارس,2018-04-25,9368,9348,0.00213492741224008,20
دپارس,2018-04-28,9257,9368,0.01199092578459642,111
دپارس,2018-04-29,8928,9257,0.03685035841881156,329
دپارس,2018-04-30,8977,8928,0.005458393672111129,49
دپارس,2018-05-05,8980,8977,3.3407572379353273e-4,3
دپارس,2018-05-06,8970,8980,0.0011148272016594395,10
دپارس,2018-05-07,8991,8970,0.0023356690020758905,21
دپارس,2018-05-08,8989,8991,2.2249415950356056e-4,2
دپارس,2018-05-09,8967,8989,0.002453440392276855,22
دپارس,2018-05-12,8968,8967,1.1150758250317711e-4,1
دپارس,2018-05-13,9165,8968,0.021494817237152773,197
دپارس,2018-05-14,9321,9165,0.01673640167184461,156
دپارس,2018-05-15,9495,9321,0.018325434437248506,174
دپارس,2018-05-16,9561,9495,0.006903043613962656,66
دپارس,2018-05-19,9561,9561,0,0
دپارس,2018-05-20,9548,9561,0.0013615416839797296,13
دپارس,2018-05-21,9535,9548,0.0013633980071983852,13
دپارس,2018-05-22,9482,9535,0.005589538071547191,53
دپارس,2018-05-23,9465,9482,0.001796090860877328,17
دپارس,2018-05-26,9455,9465,0.0010576414594333536,10
دپارس,2018-05-27,9715,9455,0.026762738031213304,260
دپارس,2018-05-28,9654,9715,0.006318624403737453,61
دپارس,2018-05-29,9632,9654,0.0022840531559090477,22
دپارس,2018-05-30,9628,9632,4.154549230976885e-4,4
دپارس,2018-06-02,9600,9628,0.0029166666663628473,28
دپارس,2018-06-03,9553,9600,0.004919920443324618,47
دپارس,2018-06-09,9530,9553,0.0024134312694214658,23
دپارس,2018-06-10,9528,9530,2.099076406160886e-4,2
دپارس,2018-06-11,9443,9528,0.009001376680186236,85
دپارس,2018-06-12,9463,9443,0.0021134946632026318,20
دپارس,2018-06-13,9480,9463,0.001793248944958518,17
دپارس,2018-06-17,9514,9480,0.003573680890942434,34
دپارس,2018-06-18,9912,9514,0.04015334947133239,398
دپارس,2018-06-23,9420,9912,0.05222929935751281,492
دپارس,2018-06-24,9309,9420,0.011923944568490283,111
دپارس,2018-06-25,9221,9309,0.009543433466051032,88
دپارس,2018-06-26,9168,9221,0.0057809773117603646,53
دپارس,2018-06-27,9115,9168,0.005814591332329721,53
دپارس,2018-06-30,8874,9115,0.02715798962957426,241
دپارس,2018-07-01,8801,8874,0.008294511986331722,73
دپارس,2018-07-02,8759,8801,0.0047950679295815654,42
دپارس,2018-07-03,8740,8759,0.0021739130432295293,19
دپارس,2018-07-04,8661,8740,0.009121348573014507,79
دپارس,2018-07-07,8571,8661,0.01050052502502619,90
دپارس,2018-07-08,8070,8571,0.062081784378924185,501
دپارس,2018-07-10,7973,8070,0.012166060452506452,97
دپارس,2018-07-11,7896,7973,0.009751773048410363,77
دپارس,2018-07-14,7808,7896,0.011270491801835234,88
دپارس,2018-07-15,7788,7808,0.0025680534151812976,20
دپارس,2018-07-16,7508,7788,0.03729355353792041,280
دپارس,2018-07-24,6358,7508,0.180874488804518,1150
دپارس,2018-07-25,6363,6358,7.857928648772916e-4,5
دپارس,2018-07-28,6149,6363,0.0348024068897703,214
دپارس,2018-07-29,6076,6149,0.012014483210662527,73
دپارس,2018-07-30,5923,6076,0.025831504300889496,153
دپارس,2018-07-31,5924,5923,1.688048615515184e-4,1
دپارس,2018-08-01,6009,5924,0.014145448491571733,85
دپارس,2018-08-04,6016,6009,0.0011635638295938225,7
دپارس,2018-08-05,5961,6016,0.009226639823984794,55
دپارس,2018-08-06,6038,5961,0.012752567073078409,77
دپارس,2018-08-07,6002,6038,0.005998000665445184,36
دپارس,2018-08-08,5966,6002,0.006034193763655013,36
دپارس,2018-08-11,5926,5966,0.00674991562491564,40
دپارس,2018-08-12,5884,5926,0.0071380013584061855,42
دپارس,2018-08-13,5864,5884,0.0034106411999640786,20
دپارس,2018-08-14,5861,5864,5.118580446149363e-4,3
دپارس,2018-08-15,5854,5861,0.0011957635802535421,7
دپارس,2018-08-18,5837,5854,0.002912455027768981,17
دپارس,2018-08-19,5865,5837,0.004774083545648068,28
دپارس,2018-08-20,5931,5865,0.01112797167237768,66
دپارس,2018-08-21,6001,5931,0.011664722544298496,70
دپارس,2018-08-25,6252,6001,0.04014715290464697,251
دپارس,2018-08-26,6562,6252,0.04724169459810398,310
دپارس,2018-08-27,6840,6562,0.040643274847859165,278
دپارس,2018-08-28,7144,6840,0.04255319148340521,304
دپارس,2018-08-29,7533,7144,0.05163945306628973,389
دپارس,2018-09-01,7908,7533,0.04742033383315372,375
دپارس,2018-09-02,7980,7908,0.009022556389846796,72
دپارس,2018-09-03,7898,7980,0.010382375283567691,82
دپارس,2018-09-04,7905,7898,8.855154964091694e-4,7
دپارس,2018-09-05,7823,7905,0.010481912308515669,82
دپارس,2018-09-08,8071,7823,0.030727295250808164,248
دپارس,2018-09-09,8461,8071,0.046093842329973544,390
دپارس,2018-09-10,8883,8461,0.04750647303303991,422
دپارس,2018-09-15,9324,8883,0.047297297292224656,441
دپارس,2018-09-16,9504,9324,0.01893939393740116,180
دپارس,2018-09-17,9956,9504,0.04539975893477302,452
دپارس,2018-09-18,10435,9956,0.045903210345385415,479
دپارس,2018-09-22,10954,10435,0.04737995252443126,519
دپارس,2018-09-23,11052,10954,0.008867173361485054,98
دپارس,2018-09-24,11156,11052,0.009322337754632275,104
دپارس,2018-09-25,11422,11156,0.023288390822685308,266
دپارس,2018-09-26,11742,11422,0.027252597510879526,320
دپارس,2018-09-29,12248,11742,0.04131286740355055,506
دپارس,2018-09-30,12859,12248,0.047515358888909294,611
دپارس,2018-10-01,12298,12859,0.04561717352044095,561
دپارس,2018-10-02,12213,12298,0.006959796937119479,85
دپارس,2018-10-03,12125,12213,0.007257731958164311,88
دپارس,2018-10-06,11524,12125,0.05215203054042415,601
دپارس,2018-10-07,11508,11524,0.0013903371566396996,16
دپارس,2018-10-08,11465,11508,0.0037505451370474885,43
دپارس,2018-10-09,11323,11465,0.012540846064422781,142
دپارس,2018-10-10,11304,11323,0.0016808209481881792,19
دپارس,2018-10-13,11247,11304,0.005068018137719568,57
دپارس,2018-10-15,10685,11247,0.05259709873162404,562
دپارس,2018-10-16,10222,10685,0.04529446291867595,463
دپارس,2018-10-17,10650,10222,0.04018779342345655,428
دپارس,2018-10-20,10725,10650,0.006993006992354964,75
دپارس,2018-10-21,10860,10725,0.012430939225374683,135
دپارس,2018-10-22,10650,10860,0.019718309857303443,210
دپارس,2018-10-23,10327,10650,0.03127723443097925,323
دپارس,2018-10-24,9849,10327,0.04853284596928289,478
دپارس,2018-10-27,9425,9849,0.04498673739575738,424
دپارس,2018-10-28,9252,9425,0.018698659747222367,173
دپارس,2018-10-29,9711,9252,0.04726598702015591,459
دپارس,2018-10-31,9611,9711,0.010404744562438378,100
دپارس,2018-11-03,9491,9611,0.012643557052719042,120
دپارس,2018-11-04,9403,9491,0.009358715302631212,88
دپارس,2018-11-05,9870,9403,0.047315096246472635,467
دپارس,2018-11-06,9919,9870,0.0049400141138280056,49
دپارس,2018-11-10,9470,9919,0.04741288278274415,449
دپارس,2018-11-11,9303,9470,0.017951198536176372,167
دپارس,2018-11-12,9317,9303,0.0015026296016418773,14
دپارس,2018-11-13,9507,9317,0.019985274006523057,190
دپارس,2018-11-14,9919,9507,0.04153644520198241,412
دپارس,2018-11-17,10019,9919,0.009981036030543863,100
دپارس,2018-11-18,10056,10019,0.003679395385473409,37
دپارس,2018-11-19,9773,10056,0.028957331420346122,283
دپارس,2018-11-20,9826,9773,0.005393853042398346,53
دپارس,2018-11-21,9892,9826,0.006672058228197325,66
دپارس,2018-11-24,10011,9892,0.011886924381991118,119
دپارس,2018-11-26,9703,10011,0.03174275996787151,308
دپارس,2018-11-27,10028,9703,0.03240925408532018,325
دپارس,2018-11-28,10099,10028,0.007030399048714685,71
دپارس,2018-12-01,9782,10099,0.0324064608431398,317
دپارس,2018-12-02,9958,9782,0.017674231771673606,176
دپارس,2018-12-03,10006,9958,0.004797121726484397,48
دپارس,2018-12-04,10056,10006,0.004972155926315418,50
دپارس,2018-12-05,10248,10056,0.018735362995829882,192
دپارس,2018-12-08,10722,10248,0.04420817011339226,474
دپارس,2018-12-09,10852,10722,0.01197935864246412,130
دپارس,2018-12-10,11084,10852,0.020931071813340755,232
دپارس,2018-12-11,10785,11084,0.027723690308046018,299
دپارس,2018-12-12,10709,10785,0.007096834437660207,76
دپارس,2018-12-15,10695,10709,0.0013090229077784925,14
دپارس,2018-12-16,10438,10695,0.024621575012011728,257
دپارس,2018-12-17,10516,10438,0.007417268922839742,78
دپارس,2018-12-18,10488,10516,0.0026697177724380513,28
دپارس,2018-12-22,10477,10488,0.0010499188698052954,11
دپارس,2018-12-23,10333,10477,0.013935933415858325,144
دپارس,2018-12-24,10356,10333,0.002220934723617136,23
دپارس,2018-12-25,10330,10356,0.002516940948449473,26
دپارس,2018-12-26,10281,10330,0.0047660733387057605,49
دپارس,2018-12-29,10262,10281,0.0018514909372586736,19
دپارس,2018-12-30,10281,10262,0.0018480692537838665,19
دپارس,2018-12-31,10497,10281,0.020577307800268903,216
دپارس,2019-01-01,10667,10497,0.01593700196719443,170
دپارس,2019-01-02,10729,10667,0.005778730542848473,62
دپارس,2019-01-05,10735,10729,5.58919422397865e-4,6
دپارس,2019-01-06,10735,10735,0,0
دپارس,2019-01-07,11066,10735,0.029911440445516767,331
دپارس,2019-01-08,11498,11066,0.0375717516057078,432
دپارس,2019-01-09,11994,11498,0.04135401033505469,496
دپارس,2019-01-12,12214,11994,0.018012117241033885,220
دپارس,2019-01-13,12248,12214,0.002775963422372962,34
دپارس,2019-01-14,12214,12248,0.0027836908463416007,34
دپارس,2019-01-15,12372,12214,0.012770772711544554,158
دپارس,2019-01-16,12878,12372,0.03929181549625005,506
دپارس,2019-01-26,6652,12878,0.9359591099013892,6226
دپارس,2019-01-27,6815,6652,0.023917828316373024,163
دپارس,2019-01-28,7155,6815,0.04751921732389668,340
دپارس,2019-01-29,7499,7155,0.04587278303162118,344
دپارس,2019-01-30,7796,7499,0.03809645971804817,297
دپارس,2019-02-02,7578,7796,0.028767484820695764,218
دپارس,2019-02-03,7518,7578,0.00798084596861122,60
دپارس,2019-02-04,7583,7518,0.0085718053529511,65
دپارس,2019-02-05,7674,7583,0.011858222568170677,91
دپارس,2019-02-06,7802,7674,0.016406049728735446,128
دپارس,2019-02-10,7792,7802,0.001283367556303469,10
دپارس,2019-02-12,7796,7792,5.130836325663053e-4,4
دپارس,2019-02-13,7763,7796,0.004250933916752423,33
دپارس,2019-02-16,7713,7763,0.006482561907625754,50
دپارس,2019-02-17,7708,7713,6.486766994487965e-4,5
دپارس,2019-02-18,7709,7708,1.2971851081466877e-4,1
دپارس,2019-02-19,7734,7709,0.0032324799582062994,25
دپارس,2019-02-20,7824,7734,0.011503067483192348,90
دپارس,2019-02-23,7688,7824,0.017689906345253654,136
دپارس,2019-02-24,7697,7688,0.0011692867349396795,9
دپارس,2019-02-25,7632,7697,0.008516771487353672,65
دپارس,2019-02-26,7545,7632,0.011530815107815664,87
دپارس,2019-02-27,7565,7545,0.0026437541305163576,20
دپارس,2019-03-02,7574,7565,0.0011882756798008614,9
دپارس,2019-03-03,7552,7574,0.002913135592834595,22
دپارس,2019-03-04,7546,7552,7.951232439974657e-4,6
دپارس,2019-03-05,7532,7546,0.0018587360592327753,14
دپارس,2019-03-06,7525,7532,9.302325580159159e-4,7
دپارس,2019-03-09,7472,7525,0.007093147750656698,53
دپارس,2019-03-10,7470,7472,2.677376170993658e-4,2
دپارس,2019-03-11,7472,7470,2.676659528549697e-4,2
دپارس,2019-03-12,7476,7472,5.350454787941351e-4,4
دپارس,2019-03-13,7479,7476,4.01123144751822e-4,3
دپارس,2019-03-16,7480,7479,1.3368983955431952e-4,1
دپارس,2019-03-17,7522,7480,0.005583621376550967,42
دپارس,2019-03-18,7519,7522,3.98989227237799e-4,3
دپارس,2019-03-19,7584,7519,0.008570675104355132,65
دپارس,2019-03-25,7620,7584,0.004724409448198896,36
دپارس,2019-03-26,7649,7620,0.0037913452733963466,29
دپارس,2019-03-27,7711,7649,0.008040461677079436,62
دپارس,2019-03-30,7812,7711,0.012928827443301481,101
دپارس,2019-03-31,7842,7812,0.0038255547049444584,30
دپارس,2019-04-06,8154,7842,0.038263428987213216,312
دپارس,2019-04-07,8162,8154,9.801519234280626e-4,8
دپارس,2019-04-08,7929,8162,0.029385798962115548,233
دپارس,2019-04-09,7879,7929,0.0063459829919601494,50
دپارس,2019-04-10,8221,7879,0.04160077848904017,342
دپارس,2019-04-13,8619,8221,0.04617705069657999,398
دپارس,2019-04-14,8878,8619,0.029173237212303083,259
دپارس,2019-04-15,8879,8878,1.126252956287166e-4,1
دپارس,2019-04-16,8730,8879,0.01706758304500944,149
دپارس,2019-04-17,8585,8730,0.016889924284578924,145
دپارس,2019-04-20,8963,8585,0.04217337944413998,378
دپارس,2019-04-22,9273,8963,0.03343038929867029,310
دپارس,2019-04-23,8917,9273,0.03992374116407718,356
دپارس,2019-04-24,9312,8917,0.04241838487516984,395
دپارس,2019-04-27,9745,9312,0.044433042581381935,433
دپارس,2019-04-28,9459,9745,0.030235754304869883,286
دپارس,2019-04-29,9688,9459,0.02363748967551223,229
دپارس,2019-04-30,10097,9688,0.04050708130726878,409
دپارس,2019-05-01,10068,10097,0.0028804131900198237,29
دپارس,2019-05-04,10510,10068,0.042055185533581806,442
دپارس,2019-05-05,11021,10510,0.046366028486855455,511
دپارس,2019-05-06,10554,11021,0.04424862610912937,467
دپارس,2019-05-07,10353,10554,0.019414662414815546,201
دپارس,2019-05-08,10417,10353,0.006143803397701468,64
دپارس,2019-05-11,10931,10417,0.04702223034973724,514
دپارس,2019-05-12,11279,10931,0.030853799092929,348
دپارس,2019-05-13,11398,11279,0.01044042814437266,119
دپارس,2019-05-14,11967,11398,0.047547422073406245,569
دپارس,2019-05-15,12565,11967,0.047592518897923396,598
دپارس,2019-05-18,12896,12565,0.025666873447141216,331
دپارس,2019-05-19,12755,12896,0.011054488435040808,141
دپارس,2019-05-20,12787,12755,0.0025025416436613326,32
دپارس,2019-05-21,13256,12787,0.0353802051874336,469
دپارس,2019-05-22,13404,13256,0.011041480154353814,148
دپارس,2019-05-25,13250,13404,0.011622641508556781,154
دپارس,2019-05-26,13699,13250,0.0327761150425012,449
دپارس,2019-05-28,14305,13699,0.0423628102032602,606
دپارس,2019-05-29,14849,14305,0.03663546366511984,544
دپارس,2019-06-01,14456,14849,0.027185943550969427,393
دپارس,2019-06-02,14797,14456,0.023045211865712966,341
دپارس,2019-06-03,15523,14797,0.04676931005303296,726
دپارس,2019-06-08,15698,15523,0.011147916931383112,175
دپارس,2019-06-09,16211,15698,0.03164517919735703,513
دپارس,2019-06-10,17002,16211,0.04652393835745654,791
دپارس,2019-06-11,17055,17002,0.0031075930810256468,53
دپارس,2019-06-12,17138,17055,0.004843038860728029,83
دپارس,2019-06-15,16892,17138,0.014563106795254374,246
دپارس,2019-06-16,16528,16892,0.022023233299732378,364
دپارس,2019-06-17,15752,16528,0.04926358557330729,776
دپارس,2019-06-18,16106,15752,0.02197938656264874,354
دپارس,2019-06-19,16674,16106,0.034065011392943205,568
دپارس,2019-06-22,16585,16674,0.005366294844415659,89
دپارس,2019-06-23,16511,16585,0.004481860577525173,74
دپارس,2019-06-24,16965,16511,0.02676097848353899,454
دپارس,2019-06-25,16972,16965,4.12444025429387e-4,7
دپارس,2019-06-26,17042,16972,0.004107499119580595,70
دپارس,2019-06-30,17566,17042,0.029830354091436275,524
دپارس,2019-07-01,18022,17566,0.025302408166390945,456
دپارس,2019-07-02,18462,18022,0.023832737513604554,440
دپارس,2019-07-03,18673,18462,0.011299737588427155,211
دپارس,2019-07-06,19584,18673,0.04651756535710184,911
دپارس,2019-07-07,20421,19584,0.040987219037217214,837
دپارس,2019-07-08,20940,20421,0.024785100285349325,519
دپارس,2019-07-09,21824,20940,0.04050586510078327,884
دپارس,2019-07-10,22608,21824,0.03467799009046895,784
دپارس,2019-07-13,23691,22608,0.04571356211026493,1083
دپارس,2019-07-14,24846,23691,0.046486355950797455,1155
دپارس,2019-07-17,24954,24846,0.004327963452579628,108
دپارس,2019-07-20,23910,24954,0.043663739019503815,1044
دپارس,2019-07-28,20262,23910,0.1800414569055354,3648
دپارس,2019-07-29,20041,20262,0.011027393842072382,221
دپارس,2019-07-30,19172,20041,0.0453265178361503,869
دپارس,2019-07-31,18311,19172,0.04702091638648785,861
دپارس,2019-08-03,18843,18311,0.02823329618276106,532
دپارس,2019-08-04,19079,18843,0.012369621048672907,236
دپارس,2019-08-05,20032,19079,0.04757388178676249,953
دپارس,2019-08-06,21015,20032,0.046776112298511724,983
دپارس,2019-08-07,22060,21015,0.047370806888151824,1045
دپارس,2019-08-10,22426,22060,0.016320342458917312,366
دپارس,2019-08-11,22552,22426,0.005587087619475564,126
دپارس,2019-08-14,23601,22552,0.04444726918162589,1049
دپارس,2019-08-17,24514,23601,0.03724402382160218,913
دپارس,2019-08-18,25679,24514,0.04536781027121898,1165
دپارس,2019-08-19,26868,25679,0.04425338692704134,1189
دپارس,2019-08-21,27995,26868,0.04025718878227336,1127
دپارس,2019-08-24,29375,27995,0.04697872340265604,1380
دپارس,2019-08-25,28622,29375,0.026308434070773934,753
دپارس,2019-08-26,30050,28622,0.0475207986673038,1428
دپارس,2019-08-27,30746,30050,0.022637091002971538,696
دپارس,2019-08-28,30107,30746,0.021224299995973552,639
دپارس,2019-08-31,29403,30107,0.023943135053431857,704
دپارس,2019-09-01,29899,29403,0.016589183584180434,496
دپارس,2019-09-02,29201,29899,0.023903290982366928,698
دپارس,2019-09-03,28906,29201,0.010205493668781377,295
دپارس,2019-09-04,29651,28906,0.025125628139856138,745
دپارس,2019-09-07,29995,29651,0.011468578095967042,344
دپارس,2019-09-08,29466,29995,0.017952894861265428,529
دپارس,2019-09-11,28979,29466,0.016805272783160036,487
دپارس,2019-09-14,30276,28979,0.04283921257620428,1297
دپارس,2019-09-15,31659,30276,0.04368426039850645,1383
دپارس,2019-09-16,32470,31659,0.024976901754697352,811
دپارس,2019-09-17,31469,32470,0.03180908195265788,1001
دپارس,2019-09-18,30499,31469,0.0318043214521196,970
دپارس,2019-09-21,30411,30499,0.002893689783206942,88
دپارس,2019-09-22,30800,30411,0.012629870129460069,389
دپارس,2019-09-23,32072,30800,0.0396607632813775,1272
دپارس,2019-09-24,31476,32072,0.018935061633659454,596
دپارس,2019-09-25,31398,31476,0.0024842346645491996,78
دپارس,2019-09-28,31657,31398,0.008181444861857363,259
دپارس,2019-09-29,31911,31657,0.007959637742221816,254
دپارس,2019-09-30,33506,31911,0.04760341431243349,1595
دپارس,2019-10-01,35181,33506,0.047610926350939116,1675
دپارس,2019-10-02,36931,35181,0.047385665158068135,1750
دپارس,2019-10-05,38519,36931,0.04122640774575596,1588
دپارس,2019-10-06,36662,38519,0.050651901149673995,1857
دپارس,2019-10-07,35201,36662,0.04150450271181204,1461
دپارس,2019-10-08,33662,35201,0.04571920860181453,1539
دپارس,2019-10-09,32072,33662,0.04957595410172188,1590
دپارس,2019-10-12,33557,32072,0.04425306195296799,1485
دپارس,2019-10-13,33537,33557,5.963562632138725e-4,20
دپارس,2019-10-14,31925,33537,0.05049334377288979,1612
دپارس,2019-10-15,31430,31925,0.01574928412294784,495
دپارس,2019-10-16,30137,31430,0.04290407140581663,1293
دپارس,2019-10-20,29449,30137,0.023362423171470595,688
دپارس,2019-10-21,28870,29449,0.02005542085140092,579
دپارس,2019-10-22,30260,28870,0.045935228022275766,1390
دپارس,2019-10-23,29402,30260,0.029181688319529907,858
دپارس,2019-10-26,29891,29402,0.016359439295561894,489
دپارس,2019-10-28,31197,29891,0.0418629996460601,1306
دپارس,2019-10-30,32745,31197,0.04727439303566119,1548
دپارس,2019-11-02,32747,32745,6.107429688029211e-5,2
دپارس,2019-11-03,32802,32747,0.0016767270287885883,55
دپارس,2019-11-04,31851,32802,0.029857775265145277,951
دپارس,2019-11-05,31992,31851,0.0044073518378217255,141
دپارس,2019-11-09,30522,31992,0.048161981519947515,1470
دپارس,2019-11-10,29896,30522,0.020939256087070535,626
دپارس,2019-11-11,30220,29896,0.010721376571451972,324
دپارس,2019-11-12,30851,30220,0.020453145764466205,631
دپارس,2019-11-13,30531,30851,0.010481150305902815,320
دپارس,2019-11-16,30093,30531,0.01455487987191191,438
دپارس,2019-11-17,28683,30093,0.04915803786043447,1410
دپارس,2019-11-18,28953,28683,0.009325458501387577,270
دپارس,2019-11-19,29278,28953,0.011100485005427266,325
دپارس,2019-11-20,29225,29278,0.00181351582542982,53
دپارس,2019-11-23,29546,29225,0.01086441481043578,321
دپارس,2019-11-24,29435,29546,0.003771020893366026,111
دپارس,2019-11-25,30454,29435,0.03346030078040782,1019
دپارس,2019-11-26,31595,30454,0.03611330906674748,1141
دپارس,2019-11-27,31592,31595,9.496074955384399e-5,3
دپارس,2019-11-30,32134,31592,0.01686686998142569,542
دپارس,2019-12-01,33027,32134,0.02703848366406157,893
دپارس,2019-12-02,33083,33027,0.0016927122690900851,56
دپارس,2019-12-03,32332,33083,0.023227761968847342,751
دپارس,2019-12-04,32380,32332,0.0014823965410289562,48
دپارس,2019-12-07,32292,32380,0.0027251331598313784,88
دپارس,2019-12-08,31752,32292,0.01700680272055282,540
دپارس,2019-12-09,32471,31752,0.022142835144524566,719
دپارس,2019-12-10,32800,32471,0.010030487804572242,329
دپارس,2019-12-11,32371,32800,0.013252602637754391,429
دپارس,2019-12-14,32971,32371,0.018197810196287714,600
دپارس,2019-12-15,33274,32971,0.009106209051839087,303
دپارس,2019-12-16,32919,33274,0.010784045687573011,355
دپارس,2019-12-17,34062,32919,0.033556455873596486,1143
دپارس,2019-12-18,34483,34062,0.012208914537244181,421
دپارس,2019-12-21,34505,34483,6.375887552343837e-4,22
دپارس,2019-12-22,33925,34505,0.01709653647702,580
دپارس,2019-12-23,34005,33925,0.002352595206518083,80
دپارس,2019-12-24,33259,34005,0.022430018941566793,746
دپارس,2019-12-25,32958,33259,0.009132835730046336,301
دپارس,2019-12-28,33425,32958,0.013971578159641838,467
دپارس,2019-12-29,33329,33425,0.0028803744485919056,96
دپارس,2019-12-30,34933,33329,0.04591646866727975,1604
دپارس,2019-12-31,35190,34933,0.0073032111393207385,257
دپارس,2020-01-01,35106,35190,0.002392753375423211,84
دپارس,2020-01-04,33357,35106,0.052432772729788864,1749
دپارس,2020-01-05,33138,33357,0.006608727140847102,219
دپارس,2020-01-07,32341,33138,0.02464364119771672,797
دپارس,2020-01-08,31703,32341,0.02012427845881701,638
دپارس,2020-01-11,32186,31703,0.015006524575436322,483
دپارس,2020-01-12,33795,32186,0.047610593281621226,1609
دپارس,2020-01-13,35291,33795,0.04239041115178401,1496
دپارس,2020-01-14,35210,35291,0.0023004828173160898,81
دپارس,2020-01-15,35556,35210,0.009731128360621804,346
دپارس,2020-01-18,37188,35556,0.04388512423244366,1632
دپارس,2020-01-19,37944,37188,0.01992409867120166,756
دپارس,2020-01-20,38426,37944,0.012543590277089898,482
دپارس,2020-01-21,38203,38426,0.005837237913100091,223
دپارس,2020-01-22,39641,38203,0.036275573269184035,1438
دپارس,2020-01-25,41570,39641,0.04640365648192438,1929
دپارس,2020-01-26,41699,41570,0.0030935993668171034,129
دپارس,2020-01-27,40814,41699,0.021683735972419176,885
دپارس,2020-01-28,40629,40814,0.004553397819179566,185
دپارس,2020-02-01,40076,40629,0.013798782313259837,553
دپارس,2020-02-02,40068,40076,1.9966057701408454e-4,8
دپارس,2020-02-03,40729,40068,0.016229222420972054,661
دپارس,2020-02-04,40005,40729,0.018097737782324767,724
دپارس,2020-02-05,40545,40005,0.013318534960825785,540
دپارس,2020-02-08,41162,40545,0.014989553471284448,617
دپارس,2020-02-09,39367,41162,0.0455965656502757,1795
دپارس,2020-02-10,38695,39367,0.0173665848296326,672
دپارس,2020-02-12,39751,38695,0.026565369424000267,1056
دپارس,2020-02-15,39399,39751,0.00893423690933947,352
دپارس,2020-02-16,39490,39399,0.0023043808558545356,91
دپارس,2020-02-17,38651,39490,0.021707070967847998,839
دپارس,2020-02-18,40115,38651,0.036495076653708214,1464
دپارس,2020-02-19,42120,40115,0.04760208926762578,2005
دپارس,2020-02-22,44226,42120,0.0476190476179709,2106
دپارس,2020-02-23,46437,44226,0.04761289488882544,2211
دپارس,2020-02-24,48758,46437,0.04760244472604286,2321
دپارس,2020-02-25,51152,48758,0.04680168908260084,2394
دپارس,2020-02-26,51658,51152,0.009795191451279663,506
دپارس,2020-02-29,52442,51658,0.014949849357100227,784
دپارس,2020-03-01,54984,52442,0.04623163101909225,2542
دپارس,2020-03-02,57604,54984,0.045482952571948426,2620
دپارس,2020-03-03,58065,57604,0.00793937828282202,461
دپارس,2020-03-07,55168,58065,0.05251232598512703,2897
دپارس,2020-03-09,53453,55168,0.032084260938916725,1715
دپارس,2020-03-10,50912,53453,0.04990964801913282,2541
دپارس,2020-03-11,52755,50912,0.03493507724320093,1843
دپارس,2020-03-14,50742,52755,0.03967127823026938,2013
دپارس,2020-03-15,48788,50742,0.04005083217102462,1954
دپارس,2020-03-16,50611,48788,0.03601983758400309,1823
دپارس,2020-03-17,50413,50611,0.003927558367803393,198
دپارس,2020-03-18,52905,50413,0.04710329836410352,2492
دپارس,2020-03-24,55318,52905,0.04362052134850102,2413
دپارس,2020-03-25,57393,55318,0.036154234836371084,2075
دپارس,2020-03-28,60239,57393,0.04724514019078595,2846
دپارس,2020-03-29,61478,60239,0.02015355086339579,1239
دپارس,2020-03-30,60057,61478,0.023660855520194802,1421
دپارس,2020-04-04,59447,60057,0.010261241105349955,610
دپارس,2020-04-05,59631,59447,0.003085643373361412,184
دپارس,2020-04-06,60602,59631,0.016022573512160944,971
دپارس,2020-04-07,61187,60602,0.009560854429706295,585
دپارس,2020-04-08,61309,61187,0.001989919913846419,122
دپارس,2020-04-11,60805,61309,0.00828879203999196,504
دپارس,2020-04-12,61289,60805,0.007897012514351726,484
دپارس,2020-04-13,62244,61289,0.015342844289966216,955
دپارس,2020-04-14,61527,62244,0.011653420449369328,717
دپارس,2020-04-15,63464,61527,0.030521240387770685,1937
دپارس,2020-04-18,66494,63464,0.04556802117415755,3030
دپارس,2020-04-19,68991,66494,0.036193126639182026,2497
دپارس,2020-04-20,68911,68991,0.0011609177054293087,80
دپارس,2020-04-21,67692,68911,0.018008036399899428,1219
دپارس,2020-04-22,68579,67692,0.012933988538576913,887
دپارس,2020-04-25,71234,68579,0.037271527640771664,2655
دپارس,2020-04-26,72213,71234,0.01355711575459326,979
دپارس,2020-04-27,71534,72213,0.00949198982288853,679
دپارس,2020-04-28,69921,71534,0.02306889203496705,1613
دپارس,2020-04-29,72044,69921,0.02946810282564172,2123
دپارس,2020-05-02,74890,72044,0.03800240352466281,2846
دپارس,2020-05-03,78634,74890,0.047612991834987246,3744
دپارس,2020-05-04,77222,78634,0.018284944704640066,1412
دپارس,2020-05-05,75433,77222,0.02371641058921538,1789
دپارس,2020-05-06,74852,75433,0.0077619836476278264,581
دپارس,2020-05-09,76675,74852,0.02377567655658591,1823
دپارس,2020-05-10,78540,76675,0.02374586198085376,1865
دپارس,2020-05-11,80885,78540,0.02899177845052863,2345
دپارس,2020-05-12,78399,80885,0.031709588132097226,2486
دپارس,2020-05-13,82210,78399,0.04635689088862235,3811
دپارس,2020-05-16,86275,82210,0.04711677774503487,4065
دپارس,2020-05-17,90038,86275,0.041793464980988106,3763
دپارس,2020-05-18,93442,90038,0.03642901478953331,3404
دپارس,2020-05-19,94089,93442,0.0068764680248820115,647
دپارس,2020-05-20,97825,94089,0.03819064656234919,3736
دپارس,2020-05-23,102486,97825,0.045479382549367925,4661
دپارس,2020-05-26,98162,102486,0.044049632240133155,4324
دپارس,2020-05-27,95766,98162,0.025019317920503947,2396
دپارس,2020-05-30,98830,95766,0.031002731963664855,3064
دپارس,2020-05-31,98479,98830,0.003564211659302347,351
دپارس,2020-06-01,99445,98479,0.009713912212683253,966
دپارس,2020-06-02,99736,99445,0.0029177027351917294,291
دپارس,2020-06-06,103373,99736,0.03518326835793502,3637
دپارس,2020-06-07,108535,103373,0.04756069470633841,5162
دپارس,2020-06-08,108283,108535,0.0023272351153705824,252
دپارس,2020-06-09,107256,108283,0.009575221898918707,1027
دپارس,2020-06-10,108609,107256,0.01245753114371316,1353
دپارس,2020-06-13,113260,108609,0.041064806639227756,4651
دپارس,2020-06-14,118920,113260,0.04759502186303738,5660
دپارس,2020-06-15,124860,118920,0.047573282075544024,5940
دپارس,2020-06-16,127950,124860,0.024150058616458383,3090
دپارس,2020-06-20,134340,127950,0.04756587762358518,6390
دپارس,2020-06-21,135910,134340,0.011551762195485602,1570
دپارس,2020-06-22,138870,135910,0.021314898826086878,2960
دپارس,2020-06-23,145770,138870,0.047334842559872845,6900
دپارس,2020-06-24,146430,145770,0.004507273099743855,660
دپارس,2020-06-27,150250,146430,0.025424292845088688,3820
دپارس,2020-07-01,149160,150250,0.007307589165947254,1090
دپارس,2020-07-04,148750,149160,0.0027563025209898736,410
دپارس,2020-07-05,143080,148750,0.039628180038861975,5670
دپارس,2020-07-06,145810,143080,0.01872299567918028,2730
دپارس,2020-07-07,144070,145810,0.01207746234460972,1740
دپارس,2020-07-08,140350,144070,0.026505165657096506,3720
دپارس,2020-07-11,137670,140350,0.019466840996444634,2680
دپارس,2020-07-12,132930,137670,0.03565786504148305,4740
دپارس,2020-07-13,129140,132930,0.029347994424428158,3790
دپارس,2020-07-14,123500,129140,0.045668016193962206,5640
دپارس,2020-07-15,120040,123500,0.028823725424618266,3460
دپارس,2020-07-18,125850,120040,0.04616607071874322,5810
دپارس,2020-07-19,127750,125850,0.01487279843432585,1900
دپارس,2020-07-20,130930,127750,0.02428778736711,3180
دپارس,2020-07-21,131240,130930,0.002362084730247165,310
دپارس,2020-07-22,129670,131240,0.012107657900731799,1570
دپارس,2020-07-25,123410,129670,0.050725224859811,6260
دپارس,2020-07-26,117670,123410,0.0487804878044635,5740
دپارس,2020-07-27,115580,117670,0.01808271327203597,2090
دپارس,2020-07-28,109810,115580,0.05254530552725121,5770
دپارس,2020-07-29,112090,109810,0.020340797573197067,2280
دپارس,2020-08-01,116780,112090,0.04016098646994211,4690
دپارس,2020-08-02,122540,116780,0.04700505957200094,5760
دپارس,2020-08-03,119060,122540,0.029228960187894937,3480
دپارس,2020-08-04,116090,119060,0.025583598931642835,2970
دپارس,2020-08-05,112470,116090,0.032186360807040224,3620
دپارس,2020-08-09,115680,112470,0.027748962655361784,3210
دپارس,2020-08-10,112750,115680,0.02598669623036819,2930
دپارس,2020-08-11,108970,112750,0.034688446361065536,3780
دپارس,2020-08-12,106120,108970,0.026856388993339086,2850
دپارس,2020-08-15,104260,106120,0.01784001534607865,1860
دپارس,2020-08-16,102190,104260,0.02025638516469071,2070
دپارس,2020-08-17,102160,102190,2.9365700861106445e-4,30
دپارس,2020-08-18,107120,102160,0.04630321135132279,4960
دپارس,2020-08-19,106140,107120,0.009233088373758875,980
دپارس,2020-08-22,104380,106140,0.01686146771395994,1760
دپارس,2020-08-23,103570,104380,0.007820797528166256,810
دپارس,2020-08-24,100460,103570,0.03095759506240337,3110
دپارس,2020-08-25,100410,100460,4.979583706752519e-4,50
دپارس,2020-08-26,103170,100410,0.026751962779618572,2760
دپارس,2020-08-31,102920,103170,0.002429071123178886,250
دپارس,2020-09-01,100680,102920,0.02224870878007302,2240
دپارس,2020-09-02,100430,100680,0.0024892960270587548,250
دپارس,2020-09-05,97760,100430,0.027311783960440757,2670
دپارس,2020-09-06,97270,97760,0.005037524416520638,490
دپارس,2020-09-07,97220,97270,5.142974696511593e-4,50
دپارس,2020-09-08,92810,97220,0.04751643141851615,4410
دپارس,2020-09-09,91380,92810,0.01564893849840612,1430
ملت,2018-01-17,1894,1896,0.001055966208523777,2
ملت,2018-01-20,1894,1894,0,0
ملت,2018-01-22,1815,1894,0.04352617077491671,79
ملت,2018-01-23,1817,1815,0.0011007154644464966,2
ملت,2018-01-24,1897,1817,0.04217185026770066,80
ملت,2018-01-28,1897,1897,0,0
ملت,2018-01-29,1896,1897,5.274261600593744e-4,1
ملت,2018-01-30,1900,1896,0.0021052631567867034,4
ملت,2018-01-31,1899,1900,5.265929433772549e-4,1
ملت,2018-02-03,1899,1899,0,0
ملت,2018-02-04,1899,1899,0,0
ملت,2018-02-05,1899,1899,0,0
ملت,2018-02-06,1899,1899,0,0
ملت,2018-02-07,1917,1899,0.00938967135660424,18
ملت,2018-02-10,1935,1917,0.009302325576587944,18
ملت,2018-02-12,1933,1935,0.0010346611479386128,2
ملت,2018-02-13,1978,1933,0.022750252769084805,45
ملت,2018-02-14,1980,1978,0.001010101009590858,2
ملت,2018-02-17,1980,1980,0,0
ملت,2018-02-18,1978,1980,0.0010111223452926581,2
ملت,2018-02-19,1978,1978,0,0
ملت,2018-02-21,1979,1978,5.053057096991886e-4,1
ملت,2018-02-24,1979,1979,0,0
ملت,2018-02-25,1979,1979,0,0
ملت,2018-02-26,1979,1979,0,0
ملت,2018-02-27,1979,1979,0,0
ملت,2018-02-28,1980,1979,5.05050504795429e-4,1
ملت,2018-03-03,1980,1980,0,0
ملت,2018-03-04,1980,1980,0,0
ملت,2018-03-05,1978,1980,0.0010111223452926581,2
ملت,2018-03-06,1977,1978,5.058168940284183e-4,1
ملت,2018-03-07,1975,1977,0.0010126582273353628,2
ملت,2018-03-10,1975,1975,0,0
ملت,2018-03-11,1927,1975,0.024909185249138977,48
ملت,2018-03-12,1938,1927,0.005675954589434491,11
ملت,2018-03-13,1938,1938,0,0
ملت,2018-03-14,1937,1938,5.162622609621774e-4,1
ملت,2018-03-17,1935,1937,0.001033591730731994,2
ملت,2018-03-18,1933,1935,0.0010346611479386128,2
ملت,2018-03-19,1902,1933,0.01629863300930671,31
ملت,2018-03-25,1905,1902,0.0015748031487796308,3
ملت,2018-03-26,1907,1905,0.001048767697404946,2
ملت,2018-03-27,1907,1907,0,0
ملت,2018-03-28,1907,1907,0,0
ملت,2018-04-03,1910,1907,0.0015706806274499053,3
ملت,2018-04-04,1912,1910,0.001046025104055426,2
ملت,2018-04-07,1914,1912,0.0010449320788688964,2
ملت,2018-04-08,1914,1914,0,0
ملت,2018-04-09,1914,1914,0,0
ملت,2018-04-10,1914,1914,0,0
ملت,2018-04-11,1914,1914,0,0
ملت,2018-04-16,1914,1914,0,0
ملت,2018-04-18,1918,1914,0.002085505734053438,4
ملت,2018-04-21,1918,1918,0,0
ملت,2018-04-22,1918,1918,0,0
ملت,2018-04-24,1918,1918,0,0
ملت,2018-04-25,1912,1918,0.0031380753121662782,6
ملت,2018-04-28,1899,1912,0.006845708263904313,13
ملت,2018-04-29,1898,1899,5.268703896064961e-4,1
ملت,2018-05-07,1883,1898,0.007966011679253312,15
ملت,2018-05-08,1883,1883,0,0
ملت,2018-05-09,1881,1883,0.0010632642205936926,2
ملت,2018-05-12,1881,1881,0,0
ملت,2018-05-13,1881,1881,0,0
ملت,2018-05-14,1881,1881,0,0
ملت,2018-05-15,1882,1881,5.313496277729279e-4,1
ملت,2018-05-20,1881,1882,5.316321102968463e-4,1
ملت,2018-05-21,1879,1881,0.0010643959547289004,2
ملت,2018-05-22,1879,1879,0,0
ملت,2018-05-23,1879,1879,0,0
ملت,2018-05-27,1878,1879,5.324813628687533e-4,1
ملت,2018-05-28,1878,1878,0,0
ملت,2018-05-30,1878,1878,0,0
ملت,2018-06-02,1878,1878,0,0
ملت,2018-06-03,1878,1878,0,0
ملت,2018-06-11,1874,1878,0.0021344717171107408,4
ملت,2018-06-12,1874,1874,0,0
ملت,2018-06-13,1874,1874,0,0
ملت,2018-06-17,1873,1874,5.33902829399945e-4,1
ملت,2018-06-19,1866,1873,0.003751339762191136,7
ملت,2018-06-20,1866,1866,0,0
ملت,2018-06-25,1875,1866,0.00479999999744,9
ملت,2018-06-26,1873,1875,0.00106780565879989,2
ملت,2018-06-27,1873,1873,0,0
ملت,2018-06-30,1872,1873,5.341880339026773e-4,1
ملت,2018-07-01,1872,1872,0,0
ملت,2018-07-02,1861,1872,0.005910800641638473,11
ملت,2018-07-03,1861,1861,0,0
ملت,2018-07-04,1861,1861,0,0
ملت,2018-07-07,1845,1861,0.00867208671616689,16
ملت,2018-07-08,1845,1845,0,0
ملت,2018-07-11,1845,1845,0,0
ملت,2018-07-14,1845,1845,0,0
ملت,2018-07-15,1882,1845,0.019659936227598332,37
ملت,2018-07-22,1722,1882,0.09291521481247664,160
ملت,2018-07-23,1722,1722,0,0
ملت,2018-07-24,1722,1722,0,0
ملت,2018-07-28,1722,1722,0,0
ملت,2018-07-29,1722,1722,0,0
ملت,2018-08-01,1722,1722,0,0
ملت,2018-08-04,1722,1722,0,0
ملت,2018-08-06,1726,1722,0.0023174971017859225,4
ملت,2018-08-07,1744,1726,0.01032110091151313,18
ملت,2018-08-08,1744,1744,0,0
ملت,2018-08-11,1747,1744,0.0017172295353650659,3
ملت,2018-08-12,1749,1747,0.0011435105768190334,2
ملت,2018-08-13,1749,1749,0,0
ملت,2018-08-14,1749,1749,0,0
ملت,2018-08-15,1749,1749,0,0
ملت,2018-08-18,1742,1749,0.004018369687704725,7
ملت,2018-08-19,1741,1742,5.74382538440906e-4,1
ملت,2018-08-21,1741,1741,0,0
ملت,2018-08-25,1738,1741,0.0017261219782933705,3
ملت,2018-08-26,1728,1738,0.005787037033688057,10
ملت,2018-08-27,1727,1728,5.790387952640192e-4,1
ملت,2018-08-28,1726,1727,5.793742754464806e-4,1
ملت,2018-08-29,1727,1726,5.790387952640192e-4,1
ملت,2018-09-01,1729,1727,0.0011567379981742404,2
ملت,2018-09-02,1793,1729,0.03569436696280292,64
ملت,2018-09-03,1836,1793,0.02342047929007599,43
ملت,2018-09-04,1829,1836,0.0038272279913465126,7
ملت,2018-09-05,1805,1829,0.013296398884600331,24
ملت,2018-09-08,1811,1805,0.0033130866906056944,6
ملت,2018-09-09,1838,1811,0.01468988029668668,27
ملت,2018-09-10,1882,1838,0.023379383622008826,44
ملت,2018-09-11,1946,1882,0.0328879753171182,64
ملت,2018-09-12,2030,1946,0.04137931032444369,84
ملت,2018-09-15,2048,2030,0.008789062495708466,18
ملت,2018-09-16,2057,2048,0.004375303838417451,9
ملت,2018-09-17,2061,2057,0.0019408054333135347,4
ملت,2018-09-18,2060,2061,4.8543689296823457e-4,1
ملت,2018-09-22,2071,2060,0.005311443744417459,11
ملت,2018-09-23,2174,2071,0.047378104854011914,103
ملت,2018-09-24,2282,2174,0.04732690620187252,108
ملت,2018-09-25,2396,2282,0.047579298811527844,114
ملت,2018-09-26,2476,2396,0.03231017769292804,80
ملت,2018-09-29,2727,2476,0.09204253755333974,251
ملت,2018-10-01,2855,2727,0.04483362520321064,128
ملت,2018-10-02,2713,2855,0.05234058236183539,142
ملت,2018-10-03,2585,2713,0.04951644098664741,128
ملت,2018-10-06,2615,2585,0.011472275330220928,30
ملت,2018-10-07,2602,2615,0.004996156800539525,13
ملت,2018-10-08,2583,2602,0.007355787840744953,19
ملت,2018-10-09,2461,2583,0.0495733441488934,122
ملت,2018-10-10,2444,2461,0.006955810144453433,17
ملت,2018-10-13,2443,2444,4.0933278738872994e-4,1
ملت,2018-10-14,2441,2443,8.193363372309151e-4,2
ملت,2018-10-15,2426,2441,0.006183017309899828,15
ملت,2018-10-16,2446,2426,0.008176614878096233,20
ملت,2018-10-17,2447,2446,4.086636696327488e-4,1
ملت,2018-10-20,2511,2447,0.025487853434692214,64
ملت,2018-10-21,2636,2511,0.047420333821160725,125
ملت,2018-10-22,2725,2636,0.03266055044673007,89
ملت,2018-10-23,2626,2725,0.037699923824181296,99
ملت,2018-10-24,2670,2626,0.01647940074289161,44
ملت,2018-10-27,2654,2670,0.006028636018828698,16
ملت,2018-10-28,2760,2654,0.03840579708753413,106
ملت,2018-10-29,2809,2760,0.01744393021806909,49
ملت,2018-10-31,2906,2809,0.033379215404893595,97
ملت,2018-11-03,3006,2906,0.03326679972279881,100
ملت,2018-11-04,2890,3006,0.04013840829060955,116
ملت,2018-11-05,2807,2890,0.02956893479530854,83
ملت,2018-11-06,2815,2807,0.0028419182938394607,8
ملت,2018-11-10,2818,2815,0.0010645848115455696,3
ملت,2018-11-11,2791,2818,0.009673951985068452,27
ملت,2018-11-12,2759,2791,0.011598405215078504,32
ملت,2018-11-13,2753,2759,0.002179440609451711,6
ملت,2018-11-14,2749,2753,0.0014550745720425338,4
ملت,2018-11-17,2727,2749,0.008067473411049698,22
ملت,2018-11-18,2673,2727,0.020202020194462395,54
ملت,2018-11-19,2674,2673,3.739715780202051e-4,1
ملت,2018-11-20,2673,2674,3.741114850826369e-4,1
ملت,2018-11-21,2676,2673,0.0011210762327649192,3
ملت,2018-11-24,2654,2676,0.008289374525889459,22
ملت,2018-11-26,2596,2654,0.022342064706339728,58
ملت,2018-11-27,2586,2596,0.0038669760232532963,10
ملت,2018-11-28,2583,2586,0.001161440185380782,3
ملت,2018-12-01,2548,2583,0.01373626373087274,35
ملت,2018-12-02,2519,2548,0.011512504957716354,29
ملت,2018-12-03,2540,2519,0.008267716532178065,21
ملت,2018-12-04,2525,2540,0.005940594057053231,15
ملت,2018-12-05,2521,2525,0.0015866719549438033,4
ملت,2018-12-08,2498,2521,0.009207365889028277,23
ملت,2018-12-09,2492,2498,0.0024077046539294927,6
ملت,2018-12-10,2539,2492,0.018511224884398887,47
ملت,2018-12-11,2538,2539,3.9401103215366e-4,1
ملت,2018-12-12,2535,2538,0.0011834319521958848,3
ملت,2018-12-15,2522,2535,0.0051546391732138624,13
ملت,2018-12-16,2417,2522,0.04344228380494734,105
ملت,2018-12-17,2465,2417,0.0194726166249604,48
ملت,2018-12-18,2519,2465,0.021437078197127004,54
ملت,2018-12-19,2574,2519,0.021367521359220078,55
ملت,2018-12-22,2547,2574,0.010600706709618882,27
ملت,2018-12-23,2526,2547,0.008313539189107863,21
ملت,2018-12-24,2514,2526,0.004773269687838795,12
ملت,2018-12-25,2508,2514,0.0023923444966537704,6
ملت,2018-12-26,2488,2508,0.008038585205772273,20
ملت,2018-12-29,2469,2488,0.007695423245161838,19
ملت,2018-12-30,2456,2469,0.0052931596069653265,13
ملت,2018-12-31,2452,2456,0.0016313213696446487,4
ملت,2019-01-01,2430,2452,0.009053497938661113,22
ملت,2019-01-02,2412,2430,0.007462686564070196,18
ملت,2019-01-05,2400,2412,0.004999999997916667,12
ملت,2019-01-06,2406,2400,0.002493765584998435,6
ملت,2019-01-07,2496,2406,0.03605769229324612,90
ملت,2019-01-08,2587,2496,0.03517587938338776,91
ملت,2019-01-09,2609,2587,0.008432349555986068,22
ملت,2019-01-12,2567,2609,0.01636151148564024,42
ملت,2019-01-13,2474,2567,0.0375909458215073,93
ملت,2019-01-14,2504,2474,0.011980830666141841,30
ملت,2019-01-15,2519,2504,0.00595474394364639,15
ملت,2019-01-16,2416,2519,0.042632450313479946,103
ملت,2019-01-19,2323,2416,0.0400344382091974,93
ملت,2019-01-20,2319,2323,0.001724881413658956,4
ملت,2019-01-21,2292,2319,0.011780104706902224,27
ملت,2019-01-22,2303,2292,0.004776378634487027,11
ملت,2019-01-23,2289,2303,0.006116207948398337,14
ملت,2019-01-26,2295,2289,0.0026143790838281575,6
ملت,2019-01-27,2298,2295,0.0013054830281525314,3
ملت,2019-01-28,2298,2298,0,0
ملت,2019-01-29,2255,2298,0.019068736133450673,43
ملت,2019-01-30,2229,2255,0.011664423503066656,26
ملت,2019-02-02,2213,2229,0.007230004515485764,16
ملت,2019-02-03,2214,2213,4.516711831744936e-4,1
ملت,2019-02-04,2121,2214,0.04384724184637094,93
ملت,2019-02-05,2179,2121,0.026617714535742215,58
ملت,2019-02-06,2126,2179,0.024929444955348334,53
ملت,2019-02-10,2126,2126,0,0
ملت,2019-02-12,2132,2126,0.0028142589104998787,6
ملت,2019-02-13,2130,2132,9.389671357094052e-4,2
ملت,2019-02-16,2127,2130,0.0014104372348799073,3
ملت,2019-02-17,2123,2127,0.00188412623557036,4
ملت,2019-02-18,2122,2123,4.7125353417942816e-4,1
ملت,2019-02-19,2187,2122,0.029721079090205268,65
ملت,2019-02-20,2296,2187,0.04747386757514205,109
ملت,2019-02-23,2407,2296,0.04611549644947425,111
ملت,2019-02-24,2328,2407,0.0339347078892033,79
ملت,2019-02-25,2340,2328,0.005128205126013588,12
ملت,2019-02-26,2231,2340,0.048857014769674134,109
ملت,2019-02-27,2336,2231,0.044948630117744595,105
ملت,2019-03-02,2452,2336,0.04730831971969481,116
ملت,2019-03-03,2560,2452,0.04218749998352051,108
ملت,2019-03-04,2517,2560,0.017083829949509802,43
ملت,2019-03-05,2432,2517,0.034950657880365686,85
ملت,2019-03-06,2550,2432,0.04627450978577471,118
ملت,2019-03-09,2606,2550,0.021488871825982782,56
ملت,2019-03-10,2504,2606,0.04073482426488226,102
ملت,2019-03-11,2480,2504,0.009677419350936524,24
ملت,2019-03-12,2375,2480,0.044210526297174514,105
ملت,2019-03-13,2381,2375,0.002519949599949622,6
ملت,2019-03-16,2429,2381,0.01976121860034532,48
ملت,2019-03-17,2431,2429,8.227067047212231e-4,2
ملت,2019-03-18,2474,2431,0.01738075989596574,43
ملت,2019-03-19,2597,2474,0.04736234114464292,123
ملت,2019-03-25,2726,2597,0.04732208362167202,129
ملت,2019-03-26,2862,2726,0.04751921731393459,136
ملت,2019-03-27,2997,2862,0.045045045030015,135
ملت,2019-03-30,3076,2997,0.02568270480309405,79
ملت,2019-03-31,3169,3076,0.029346797087615402,93
ملت,2019-04-06,3015,3169,0.05107794359831577,154
ملت,2019-04-07,3086,3015,0.023007128962084535,71
ملت,2019-04-08,3119,3086,0.010580314199878066,33
ملت,2019-04-09,3065,3119,0.01761827079359926,54
ملت,2019-04-10,3055,3065,0.0032733224211871285,10
ملت,2019-04-13,3006,3055,0.016300731864171414,49
ملت,2019-04-14,3150,3006,0.04571428569977325,144
ملت,2019-04-15,3282,3150,0.0402193784155334,132
ملت,2019-04-16,3205,3282,0.02402496099094385,77
ملت,2019-04-17,3123,3205,0.026256804346379507,82
ملت,2019-04-20,3214,3123,0.028313627869224138,91
ملت,2019-04-22,3250,3214,0.011076923073514794,36
ملت,2019-04-23,3189,3250,0.019128253364964487,61
ملت,2019-04-24,3259,3189,0.02147898127601136,70
ملت,2019-04-27,3196,3259,0.019712140169051273,63
ملت,2019-04-28,3215,3196,0.00590979782086787,19
ملت,2019-04-29,3277,3215,0.01891974366221552,62
ملت,2019-04-30,3217,3277,0.018650916997621725,60
ملت,2019-05-01,3184,3217,0.010364321604785075,33
ملت,2019-05-04,3235,3184,0.015765069546904154,51
ملت,2019-05-05,3322,3235,0.02618904273745062,87
ملت,2019-05-06,3469,3322,0.042375324288735854,147
ملت,2019-05-07,3356,3469,0.033671036938715426,113
ملت,2019-05-08,3462,3356,0.030618139794737684,106
ملت,2019-05-11,3573,3462,0.0310663308057469,111
ملت,2019-05-12,3403,3573,0.04995592123127948,170
ملت,2019-05-13,3413,3403,0.0029299736293788535,10
ملت,2019-05-14,3565,3413,0.04263674613109769,152
ملت,2019-05-15,3743,3565,0.04755543680268356,178
ملت,2019-05-18,3914,3743,0.043689320377187195,171
ملت,2019-05-19,4070,3914,0.038329238319820824,156
ملت,2019-05-20,3873,4070,0.05086496254818875,197
ملت,2019-05-21,3836,3873,0.00964546402251161,37
ملت,2019-05-22,3949,3836,0.02861483919255132,113
ملت,2019-05-25,4027,3949,0.019369257506985534,78
ملت,2019-05-26,3907,4027,0.03071410288438339,120
ملت,2019-05-28,4011,3907,0.025928696079299752,104
ملت,2019-05-29,3904,4011,0.027407786878225465,107
ملت,2019-06-01,3800,3904,0.027368421045429362,104
ملت,2019-06-02,3791,3800,0.0023740437872925234,9
ملت,2019-06-03,3826,3791,0.009147935177954016,35
ملت,2019-06-08,3912,3826,0.02198364007618005,86
ملت,2019-06-09,3929,3912,0.004326800711548282,17
ملت,2019-06-10,3851,3929,0.020254479350751888,78
ملت,2019-06-11,3697,3851,0.04165539625597636,154
ملت,2019-06-12,3693,3697,0.0010831302461188383,4
ملت,2019-06-15,3661,3693,0.008740781204932865,32
ملت,2019-06-16,3638,3661,0.006322155028498583,23
ملت,2019-06-17,3617,3638,0.005805916503786034,21
ملت,2019-06-18,3554,3617,0.017726505341101154,63
ملت,2019-06-19,3495,3554,0.01688125893651466,59
ملت,2019-06-22,3367,3495,0.03801603800474724,128
ملت,2019-06-23,3376,3367,0.0026658767764615294,9
ملت,2019-06-24,3446,3376,0.020313406842625246,70
ملت,2019-06-25,3485,3446,0.011190817787319708,39
ملت,2019-06-26,3564,3485,0.022166105493219387,79
ملت,2019-06-30,3676,3564,0.030467899882897744,112
ملت,2019-07-01,3610,3676,0.018282548471389878,66
ملت,2019-07-02,3775,3610,0.04370860925994474,165
ملت,2019-07-03,3885,3775,0.028314028306740277,110
ملت,2019-07-06,3857,3885,0.007259528128789337,28
ملت,2019-07-07,4037,3857,0.0445875650124876,180
ملت,2019-07-08,4188,4037,0.0360553963619734,151
ملت,2019-07-09,4134,4188,0.013062409285664631,54
ملت,2019-07-10,4299,4134,0.03838101883266317,165
ملت,2019-07-13,4275,4299,0.005614035086406073,24
ملت,2019-07-14,4237,4275,0.008968609863354116,38
ملت,2019-07-20,3873,4237,0.0939839917134046,364
ملت,2019-07-21,3700,3873,0.0467567567441198,173
ملت,2019-07-22,3551,3700,0.04196001125261616,149
ملت,2019-07-23,3498,3551,0.015151515147183672,53
ملت,2019-07-24,3660,3498,0.04426229506987369,162
ملت,2019-07-27,3841,3660,0.04712314500205073,181
ملت,2019-07-28,3787,3841,0.014259308155727672,54
ملت,2019-07-29,3728,3787,0.01582618025326551,59
ملت,2019-07-30,3757,3728,0.0077189246718874305,29
ملت,2019-07-31,3695,3757,0.01677943165987025,62
ملت,2019-08-03,3614,3695,0.02241283895339988,81
ملت,2019-08-04,3602,3614,0.0033314825087919263,12
ملت,2019-08-05,3782,3602,0.04759386566695033,180
ملت,2019-08-06,3926,3782,0.036678553225502154,144
ملت,2019-08-07,3782,3926,0.03807509253356026,144
ملت,2019-08-10,3764,3782,0.004782146651226848,18
ملت,2019-08-11,3720,3764,0.011827956986067754,44
ملت,2019-08-13,3808,3720,0.02310924369141039,88
ملت,2019-08-14,3826,3808,0.004704652377233494,18
ملت,2019-08-17,3750,3826,0.02026666666126222,76
ملت,2019-08-18,3782,3750,0.008461131674124503,32
ملت,2019-08-19,3790,3782,0.0021108179413955627,8
ملت,2019-08-21,3845,3790,0.014304291283665985,55
ملت,2019-08-24,4035,3845,0.04708798016181215,190
ملت,2019-08-25,4230,4035,0.04609929076924366,195
ملت,2019-08-26,4436,4230,0.04643823263155134,206
ملت,2019-08-27,4302,4436,0.031148303107589884,134
ملت,2019-08-28,4316,4302,0.0032437442068480662,14
ملت,2019-08-31,4427,4316,0.025073413140936657,111
ملت,2019-09-01,4406,4427,0.004766227870003126,21
ملت,2019-09-02,4225,4406,0.04284023667625083,181
ملت,2019-09-03,4130,4225,0.023002421301936457,95
ملت,2019-09-04,4160,4130,0.007211538459804918,30
ملت,2019-09-07,4124,4160,0.008729388940657277,36
ملت,2019-09-08,4234,4124,0.02598016059849311,110
ملت,2019-09-11,4228,4234,0.0014191106902982234,6
ملت,2019-09-14,4239,4228,0.0025949516389254653,11
ملت,2019-09-15,4121,4239,0.028633826734133987,118
ملت,2019-09-16,4221,4121,0.0236910684615752,100
ملت,2019-09-17,4181,4221,0.009567089210818681,40
ملت,2019-09-18,4182,4181,2.391200382020277e-4,1
ملت,2019-09-21,4213,4182,0.007358177069224263,31
ملت,2019-09-22,4390,4213,0.040318906596738285,177
ملت,2019-09-23,4423,4390,0.00746099932004047,33
ملت,2019-09-24,4351,4423,0.016547920014583332,72
ملت,2019-09-25,4402,4351,0.011585642886963734,51
ملت,2019-09-28,4393,4402,0.0020487138624974473,9
ملت,2019-09-29,4376,4393,0.003884826324523577,17
ملت,2019-09-30,4589,4376,0.04641534102279029,213
ملت,2019-10-01,4817,4589,0.0473323645324201,228
ملت,2019-10-02,5042,4817,0.04462514874164515,225
ملت,2019-10-05,5294,5042,0.04760105779229296,252
ملت,2019-10-06,5419,5294,0.02306698652462318,125
ملت,2019-10-07,5578,5419,0.028504840439493574,159
ملت,2019-10-08,5553,5578,0.004502070951827468,25
ملت,2019-10-09,5782,5553,0.03960567277073579,229
ملت,2019-10-12,6029,5782,0.040968651510869356,247
ملت,2019-10-13,5968,6029,0.010221179622952214,61
ملت,2019-10-14,5899,5968,0.011696897777301762,69
ملت,2019-10-15,5676,5899,0.039288231141774446,223
ملت,2019-10-16,5427,5676,0.045881702589666166,249
ملت,2019-10-20,5212,5427,0.04125095931672084,215
ملت,2019-10-21,5060,5212,0.030039525685762937,152
ملت,2019-10-22,5279,5060,0.04148512975156561,219
ملت,2019-10-23,5159,5279,0.023260321763275766,120
ملت,2019-10-26,5201,5159,0.008075370119577895,42
ملت,2019-10-28,5455,5201,0.04656278642592799,254
ملت,2019-10-30,5727,5455,0.04749432511830027,272
ملت,2019-11-02,5914,5727,0.031619885013253315,187
ملت,2019-11-03,5987,5914,0.012193085015501405,73
ملت,2019-11-04,5726,5987,0.045581557798536225,261
ملت,2019-11-05,5644,5726,0.014528703044909868,82
ملت,2019-11-09,5419,5644,0.04152057574432172,225
ملت,2019-11-10,5342,5419,0.014414077121974152,77
ملت,2019-11-11,5373,5342,0.0057695886830877365,31
ملت,2019-11-12,5516,5373,0.025924583026482127,143
ملت,2019-11-13,5478,5516,0.006936838260873158,38
ملت,2019-11-16,5502,5478,0.004362050162784069,24
ملت,2019-11-17,5229,5502,0.05220883533138098,273
ملت,2019-11-18,5266,5229,0.007026205847507366,37
ملت,2019-11-19,5445,5266,0.03287419650452264,179
ملت,2019-11-20,5419,5445,0.004797933197121621,26
ملت,2019-11-23,5339,5419,0.014984079412814369,80
ملت,2019-11-24,5366,5339,0.005031680953218098,27
ملت,2019-11-25,5598,5366,0.04144337262567999,232
ملت,2019-11-26,5739,5598,0.024568740194359864,141
ملت,2019-11-27,6014,5739,0.0457266378374249,275
ملت,2019-11-30,6230,6014,0.03467094702493243,216
ملت,2019-12-01,6104,6230,0.020642201831480633,126
ملت,2019-12-02,5859,6104,0.041816009550807984,245
ملت,2019-12-03,5803,5859,0.009650180939229676,56
ملت,2019-12-04,6041,5803,0.039397450746664876,238
ملت,2019-12-07,6310,6041,0.042630744842689264,269
ملت,2019-12-08,6619,6310,0.04668378908495486,309
ملت,2019-12-09,6626,6619,0.0010564443101333467,7
ملت,2019-12-10,6661,6626,0.005254466295563059,35
ملت,2019-12-11,6638,6661,0.0034648990654617506,23
ملت,2019-12-14,6952,6638,0.04516685845150074,314
ملت,2019-12-15,6748,6952,0.030231179604292946,204
ملت,2019-12-16,7033,6748,0.04052324754151525,285
ملت,2019-12-17,6929,7033,0.015009380860873231,104
ملت,2019-12-18,7098,6929,0.023809523806169408,169
ملت,2019-12-21,7011,7098,0.0124090714573657,87
ملت,2019-12-22,6742,7011,0.03989913971523299,269
ملت,2019-12-23,6460,6742,0.043653250767236335,282
ملت,2019-12-24,6738,6460,0.04125853368339885,278
ملت,2019-12-25,6648,6738,0.013537906135147727,90
ملت,2019-12-28,6713,6648,0.009682705197425487,65
ملت,2019-12-29,6773,6713,0.008858703675054081,60
ملت,2019-12-30,7077,6773,0.04295605481942121,304
ملت,2019-12-31,7262,7077,0.02547507573320365,185
ملت,2020-01-01,7561,7262,0.039545033720467526,299
ملت,2020-01-04,7183,7561,0.05262425169808934,378
ملت,2020-01-05,6835,7183,0.05091441111179013,348
ملت,2020-01-07,6541,6835,0.044947255764417174,294
ملت,2020-01-08,6411,6541,0.02027764778969308,130
ملت,2020-01-11,6471,6411,0.009272137226198093,60
ملت,2020-01-12,6794,6471,0.04754194877133618,323
ملت,2020-01-13,7133,6794,0.04752558530106188,339
ملت,2020-01-14,7197,7133,0.008892594135210144,64
ملت,2020-01-15,7213,7197,0.002218217107691915,16
ملت,2020-01-18,7569,7213,0.047033954281010176,356
ملت,2020-01-19,7849,7569,0.03567333417815348,280
ملت,2020-01-20,7769,7849,0.010297335563097266,80
ملت,2020-01-21,7464,7769,0.04086280814029169,305
ملت,2020-01-22,7343,7464,0.016478278630467344,121
ملت,2020-01-25,7644,7343,0.039377289372137976,301
ملت,2020-01-26,8009,7644,0.04557372954856115,365
ملت,2020-01-27,8302,8009,0.035292700549832245,293
ملت,2020-01-28,8707,8302,0.046514298834671605,405
ملت,2020-02-01,8799,8707,0.010455733604903315,92
ملت,2020-02-02,8509,8799,0.03408156069642948,290
ملت,2020-02-03,8876,8509,0.041347453803363285,367
ملت,2020-02-04,9314,8876,0.047025982387048956,438
ملت,2020-02-05,9304,9314,0.0010748065347082109,10
ملت,2020-02-08,9027,9304,0.03068572061253066,277
ملت,2020-02-09,8784,9027,0.027663934423080152,243
ملت,2020-02-10,8374,8784,0.048961069972658096,410
ملت,2020-02-12,8285,8374,0.010742305369856089,89
ملت,2020-02-15,8086,8285,0.02461043779067395,199
ملت,2020-02-16,8327,8086,0.02894199591342116,241
ملت,2020-02-17,8704,8327,0.04331341911267079,377
ملت,2020-02-18,8391,8704,0.0373018710478725,313
ملت,2020-02-19,8258,8391,0.016105594573007313,133
ملت,2020-02-22,8021,8258,0.02954743797163104,237
ملت,2020-02-23,8238,8021,0.026341344983449703,217
ملت,2020-02-24,8137,8238,0.012412437014573867,101
ملت,2020-02-25,8468,8137,0.03908833254143973,331
ملت,2020-02-29,8279,8468,0.022828844060535227,189
ملت,2020-03-01,8311,8279,0.0038503188540668608,32
ملت,2020-03-02,8532,8311,0.025902484760208334,221
ملت,2020-03-03,8610,8532,0.009059233448425175,78
ملت,2020-03-04,8921,8610,0.034861562601181305,311
ملت,2020-03-07,8582,8921,0.039501281747902434,339
ملت,2020-03-09,8384,8582,0.023616412210923615,198
ملت,2020-03-10,7983,8384,0.050231742446419675,401
ملت,2020-03-11,7988,7983,6.259389082841839e-4,5
ملت,2020-03-14,7850,7988,0.01757961783215546,138
ملت,2020-03-15,7531,7850,0.04235825255047693,319
ملت,2020-03-18,7713,7531,0.02359652534375774,182
ملت,2020-03-24,7627,7713,0.01127573095433647,86
ملت,2020-03-25,7769,7627,0.018277770624497647,142
ملت,2020-03-28,7966,7769,0.02473010293437985,197
ملت,2020-03-29,8275,7966,0.03734138972358412,309
ملت,2020-03-30,8564,8275,0.03374591312076764,289
ملت,2020-04-04,8992,8564,0.04759786476338992,428
ملت,2020-04-05,9203,8992,0.022927306310667465,211
ملت,2020-04-06,9327,9203,0.013294735712094484,124
ملت,2020-04-07,9793,9327,0.04758500969594761,466
ملت,2020-04-08,10095,9793,0.029915799897977633,302
ملت,2020-04-11,10569,10095,0.044848140784856834,474
ملت,2020-04-12,10746,10569,0.016471245112928416,177
ملت,2020-04-13,11187,10746,0.039420756231391726,441
ملت,2020-04-14,11541,11187,0.030673251881927627,354
ملت,2020-04-15,11570,11541,0.0025064822815465443,29
ملت,2020-04-19,12158,11570,0.048363217630501464,588
ملت,2020-04-20,12550,12158,0.031235059758467326,392
ملت,2020-04-21,13177,12550,0.047582909611627616,627
ملت,2020-04-22,13835,13177,0.04756053487187853,658
ملت,2020-04-25,14383,13835,0.038100535351588645,548
ملت,2020-04-26,15057,14383,0.04476323304477896,674
ملت,2020-04-27,15710,15057,0.04156588160142802,653
ملت,2020-04-28,15749,15710,0.0024763477044589277,39
ملت,2020-04-29,16265,15749,0.03172456194087153,516
ملت,2020-05-02,17055,16265,0.04632072705679738,790
ملت,2020-05-03,17684,17055,0.035568875817938876,629
ملت,2020-05-04,16895,17684,0.046700207159118066,789
ملت,2020-05-05,16314,16895,0.035613583423095896,581
ملت,2020-05-06,15587,16314,0.04664143195954055,727
ملت,2020-05-09,15172,15587,0.027353018716889464,415
ملت,2020-05-10,14846,15172,0.021958776773409756,326
ملت,2020-05-11,14244,14846,0.042263409151764714,602
ملت,2020-05-12,13692,14244,0.04031551270520629,552
ملت,2020-05-13,14370,13692,0.047181628389201,678
ملت,2020-05-16,15039,14370,0.044484340711185295,669
ملت,2020-05-17,15722,15039,0.04344231013589605,683
ملت,2020-05-18,16285,15722,0.03457169173874291,563
ملت,2020-05-19,15711,16285,0.03653491184287856,574
ملت,2020-05-20,15977,15711,0.016648932839916822,266
ملت,2020-05-23,16775,15977,0.04757078986303602,798
ملت,2020-05-26,17284,16775,0.029449201572005947,509
ملت,2020-05-27,17379,17284,0.0054663674546598555,95
ملت,2020-05-30,17215,17379,0.009526575660207577,164
ملت,2020-05-31,17668,17215,0.025639574370294342,453
ملت,2020-06-01,18551,17668,0.04759851220701857,883
ملت,2020-06-02,19478,18551,0.047592155249635885,927
ملت,2020-06-06,20074,19478,0.029690146456625977,596
ملت,2020-06-07,20597,20074,0.02539204738430878,523
ملت,2020-06-10,21623,20597,0.047449475093768234,1026
ملت,2020-06-13,22580,21623,0.042382639502108826,957
ملت,2020-06-14,22700,22580,0.005286343612101923,120
ملت,2020-06-15,23830,22700,0.04741921946926483,1130
ملت,2020-06-16,25020,23830,0.04756195043774732,1190
ملت,2020-06-20,26270,25020,0.047582794059856,1250
ملت,2020-06-21,26420,26270,0.005677517032336203,150
ملت,2020-06-22,25100,26420,0.052589641432167746,1320
ملت,2020-06-23,26140,25100,0.039785768934973764,1040
ملت,2020-06-24,25190,26140,0.03771337832323488,950
ملت,2020-06-27,24580,25190,0.0248169243277129,610
ملت,2020-06-28,23620,24580,0.04064352243689062,960
ملت,2020-06-29,22720,23620,0.03961267605459451,900
ملت,2020-06-30,23850,22720,0.04737945492463818,1130
ملت,2020-07-01,23560,23850,0.012308998301684677,290
ملت,2020-07-04,22580,23560,0.043401240033507475,980
ملت,2020-07-05,22560,22580,8.865248226557392e-4,20
ملت,2020-07-06,23670,22560,0.04689480354681475,1110
ملت,2020-07-07,22610,23670,0.046881910656926935,1060
ملت,2020-07-08,21630,22610,0.04530744336360113,980
ملت,2020-07-11,20780,21630,0.04090471607117879,850
ملت,2020-07-12,21740,20780,0.044158233668621975,960
ملت,2020-07-13,22200,21740,0.020720720719787356,460
ملت,2020-07-14,21360,22200,0.039325842694788116,840
ملت,2020-07-15,21460,21360,0.0046598322458220025,100
ملت,2020-07-18,22420,21460,0.0428189116840848,960
ملت,2020-07-19,23530,22420,0.0471738206524788,1110
ملت,2020-07-20,24540,23530,0.04115729421185178,1010
ملت,2020-07-21,23460,24540,0.046035805624636154,1080
ملت,2020-07-22,22320,23460,0.05107526881491598,1140
ملت,2020-07-25,23280,22320,0.0412371134002905,960
ملت,2020-07-26,22460,23280,0.03650934995385088,820
ملت,2020-07-27,21350,22460,0.05199063231606601,1110
ملت,2020-07-28,21830,21350,0.02198808978369271,480
ملت,2020-07-29,21060,21830,0.0365622032271338,770
ملت,2020-08-01,21130,21060,0.003312825366620311,70
ملت,2020-08-02,21830,21130,0.0320659642678852,700
ملت,2020-08-03,22710,21830,0.0387494495799758,880
ملت,2020-08-04,23370,22710,0.028241335043720953,660
ملت,2020-08-05,22270,23370,0.049393803320637905,1100
ملت,2020-08-09,21250,22270,0.047999999997741176,1020
ملت,2020-08-10,20410,21250,0.04115629593134952,840
ملت,2020-08-11,19400,20410,0.05206185566741949,1010
ملت,2020-08-12,18990,19400,0.021590310688699824,410
ملت,2020-08-15,18080,18990,0.050331858404295805,910
ملت,2020-08-16,17340,18080,0.04267589388450543,740
ملت,2020-08-17,17910,17340,0.031825795643114135,570
ملت,2020-08-18,18590,17910,0.03657880580760738,680
ملت,2020-08-19,17730,18590,0.04850535814729242,860
ملت,2020-08-22,17070,17730,0.038664323372075905,660
ملت,2020-08-23,16850,17070,0.013056379821183597,220
ملت,2020-08-24,16010,16850,0.05246720799172597,840
ملت,2020-08-25,16550,16010,0.03262839878956928,540
ملت,2020-08-26,17310,16550,0.043905257074297786,760
ملت,2020-08-31,16840,17310,0.02790973871568232,470
ملت,2020-09-01,16350,16840,0.029969418958411657,490
ملت,2020-09-02,15590,16350,0.048749198200849955,760
فلامي,2018-01-22,6811,6851,0.005872852737355329,40
فلامي,2018-01-23,6774,6811,0.005462060819979029,37
فلامي,2018-01-24,6778,6774,5.901445853363611e-4,4
فلامي,2018-01-27,6440,6778,0.05248447204153968,338
فلامي,2018-01-30,6440,6440,0,0
فلامي,2018-01-31,6408,6440,0.004993757801967266,32
فلامي,2018-02-03,6432,6408,0.0037313432830019676,24
فلامي,2018-02-04,6447,6432,0.00232666356408769,15
فلامي,2018-02-05,6558,6447,0.016925892037675222,111
فلامي,2018-02-06,6594,6558,0.005459508643394069,36
فلامي,2018-02-07,6594,6594,0,0
فلامي,2018-02-10,6647,6594,0.007973521888374677,53
فلامي,2018-02-14,6648,6647,1.504211792794192e-4,1
فلامي,2018-02-21,6648,6648,0,0
فلامي,2018-02-24,6531,6648,0.017914561320178445,117
فلامي,2018-02-25,6521,6531,0.0015335071305729937,10
فلامي,2018-02-26,6516,6521,7.673419274451592e-4,5
فلامي,2018-02-28,6446,6516,0.010859447717831299,70
فلامي,2018-03-10,6433,6446,0.002020830094509431,13
فلامي,2018-03-12,6430,6433,4.6656298593055005e-4,3
فلامي,2018-03-17,6421,6430,0.001401650832985259,9
فلامي,2018-03-19,6387,6421,0.005323312978656128,34
فلامي,2018-03-26,6341,6387,0.0072543762801995934,46
فلامي,2018-03-28,6339,6341,3.155071777385223e-4,2
فلامي,2018-04-03,6338,6339,1.5777847899056823e-4,1
فلامي,2018-04-04,6354,6338,0.002518098834982987,16
فلامي,2018-04-08,6352,6354,3.1486146090761e-4,2
فلامي,2018-04-17,6345,6352,0.001103230890291059,7
فلامي,2018-04-22,6341,6345,6.308153287130082e-4,4
فلامي,2018-04-23,6399,6341,0.009063916235495559,58
فلامي,2018-04-24,6399,6399,0,0
فلامي,2018-04-25,6399,6399,0,0
فلامي,2018-05-05,6399,6399,0,0
فلامي,2018-05-06,6399,6399,0,0
فلامي,2018-05-09,6400,6399,1.5624999997558594e-4,1
فلامي,2018-05-15,6080,6400,0.052631578938711905,320
فلامي,2018-05-16,6080,6080,0,0
فلامي,2018-05-19,6080,6080,0,0
فلامي,2018-05-20,6078,6080,3.2905561034401846e-4,2
فلامي,2018-05-21,5954,6078,0.020826335233317714,124
فلامي,2018-05-22,5873,5954,0.013791929165027765,81
فلامي,2018-05-23,5677,5873,0.034525277429183494,196
فلامي,2018-05-26,5394,5677,0.05246570262282801,283
فلامي,2018-05-27,5397,5394,5.55864368990946e-4,3
فلامي,2018-05-28,5397,5397,0,0
فلامي,2018-06-02,5397,5397,0,0
فلامي,2018-06-03,5351,5397,0.008596524012596425,46
فلامي,2018-06-09,5350,5351,1.8691588781552973e-4,1
فلامي,2018-06-10,5350,5350,0,0
فلامي,2018-06-11,5350,5350,0,0
فلامي,2018-06-13,5355,5350,9.337068158853955e-4,5
فلامي,2018-06-17,5369,5355,0.0026075619291101577,14
فلامي,2018-06-18,5378,5369,0.0016734845664422675,9
فلامي,2018-06-19,5406,5378,0.005179430261713016,28
فلامي,2018-06-20,5437,5406,0.005701673716074733,31
فلامي,2018-06-23,5442,5437,9.187798601766299e-4,5
فلامي,2018-06-24,5458,5442,0.002931476730866347,16
فلامي,2018-06-25,5715,5458,0.04496937881977788,257
فلامي,2018-06-26,5781,5715,0.0114167099098051,66
فلامي,2018-06-27,5917,5781,0.022984620580871282,136
فلامي,2018-06-30,5912,5917,8.457374829421959e-4,5
فلامي,2018-07-01,5897,5912,0.0025436662705538974,15
فلامي,2018-07-02,5903,5897,0.0010164323223756679,6
فلامي,2018-07-03,5902,5903,1.6943409011022803e-4,1
فلامي,2018-07-04,5892,5902,0.0016972165645456182,10
فلامي,2018-07-07,6130,5892,0.03882544860704316,238
فلامي,2018-07-08,6131,6130,1.631055292508391e-4,1
فلامي,2018-07-10,6131,6131,0,0
فلامي,2018-07-11,5942,6131,0.031807472226218866,189
فلامي,2018-07-15,5941,5942,1.6832183131319274e-4,1
فلامي,2018-07-16,5931,5941,0.0016860563139966182,10
فلامي,2018-07-17,5921,5931,0.0016889039010827725,10
فلامي,2018-07-18,5921,5921,0,0
فلامي,2018-07-22,5909,5921,0.0020308004735097645,12
فلامي,2018-07-23,5908,5909,1.692620175746002e-4,1
فلامي,2018-07-24,5884,5908,0.004078857919089249,24
فلامي,2018-07-25,5862,5884,0.0037529853285989444,22
فلامي,2018-07-28,5842,5862,0.0034234851072537683,20
فلامي,2018-07-29,5837,5842,8.566044199320533e-4,5
فلامي,2018-07-30,5830,5837,0.0012006861061405341,7
فلامي,2018-07-31,5853,5830,0.0039296087469793935,23
فلامي,2018-08-01,5853,5853,0,0
فلامي,2018-08-05,5850,5853,5.128205127328512e-4,3
فلامي,2018-08-06,5848,5850,3.419972639634067e-4,2
فلامي,2018-08-07,5768,5848,0.013869625517706374,80
فلامي,2018-08-08,5733,5768,0.006105006103941216,35
فلامي,2018-08-12,5447,5733,0.05250596657747274,286
فلامي,2018-08-13,5274,5447,0.03280242699415957,173
فلامي,2018-08-15,5012,5274,0.052274541090926864,262
فلامي,2018-08-18,5040,5012,0.005555555554453262,28
فلامي,2018-08-19,5292,5040,0.04761904761004931,252
فلامي,2018-08-20,5288,5292,7.564296518993136e-4,4
فلامي,2018-08-21,5303,5288,0.002828587591395703,15
فلامي,2018-08-25,5312,5303,0.001694277108114782,9
فلامي,2018-08-26,5319,5312,0.001316036848784351,7
فلامي,2018-08-27,5584,5319,0.047457020048807835,265
فلامي,2018-08-28,5602,5584,0.0032131381643675226,18
فلامي,2018-08-29,5611,5602,0.001603992157974694,9
فلامي,2018-09-01,5772,5611,0.027893277888445377,161
فلامي,2018-09-02,5805,5772,0.005684754520984538,33
فلامي,2018-09-03,5851,5805,0.007861903946699384,46
فلامي,2018-09-04,5875,5851,0.004085106382283386,24
فلامي,2018-09-08,5896,5875,0.003561736770087901,21
فلامي,2018-09-11,5901,5896,8.473140144302128e-4,5
فلامي,2018-09-12,5905,5901,6.773920405288074e-4,4
فلامي,2018-09-15,5910,5905,8.460236885201313e-4,5
فلامي,2018-09-16,5954,5910,0.0073899899214998335,44
فلامي,2018-09-17,5962,5954,0.001341831599909119,8
فلامي,2018-09-23,8059,5962,0.26020598085864177,2097
فلامي,2018-09-24,8200,8059,0.017195121949122545,141
فلامي,2018-09-26,8417,8200,0.0257811571788308,217
فلامي,2018-09-29,8835,8417,0.0473118279516342,418
فلامي,2018-09-30,9213,8835,0.041028980783563554,378
فلامي,2018-10-01,8808,9213,0.04598092642529735,405
فلامي,2018-10-02,8656,8808,0.01756007393512476,152
فلامي,2018-10-06,8623,8656,0.003826974370424797,33
فلامي,2018-10-07,8553,8623,0.008184262830798051,70
فلامي,2018-10-10,8432,8553,0.01435009487495848,121
فلامي,2018-10-13,8383,8432,0.005845162828838702,49
فلامي,2018-10-15,8211,8383,0.02094750943600688,172
فلامي,2018-10-16,8213,8211,2.435163764466679e-4,2
فلامي,2018-10-17,8155,8213,0.007112201102745285,58
فلامي,2018-10-21,8105,8155,0.0061690314612993175,50
فلامي,2018-10-22,8082,8105,0.0028458302396874744,23
فلامي,2018-10-23,8081,8082,1.2374706099198773e-4,1
فلامي,2018-10-27,7957,8081,0.015583762722686469,124
فلامي,2018-10-28,8106,7957,0.018381445840318103,149
فلامي,2018-10-29,8106,8106,0,0
فلامي,2018-11-04,7764,8106,0.04404945903605751,342
فلامي,2018-11-05,7824,7764,0.007668711655461565,60
فلامي,2018-11-06,7844,7824,0.0025497195305265526,20
فلامي,2018-11-10,7837,7844,8.931989280473141e-4,7
فلامي,2018-11-11,7875,7837,0.004825396824784076,38
فلامي,2018-11-12,7870,7875,6.35324015167049e-4,5
فلامي,2018-11-13,7985,7870,0.014402003755240825,115
فلامي,2018-11-14,7999,7985,0.0017502187771283636,14
فلامي,2018-11-17,7997,7999,2.500937851381651e-4,2
فلامي,2018-11-18,7996,7997,1.2506253124999216e-4,1
فلامي,2018-11-19,7971,7996,0.0031363693384598708,25
فلامي,2018-11-20,7948,7971,0.0028938097630984132,23
فلامي,2018-11-21,8318,7948,0.044481846592392175,370
فلامي,2018-11-24,8346,8318,0.003354900550760256,28
فلامي,2018-11-26,8348,8346,2.3957834208917364e-4,2
فلامي,2018-11-27,8387,8348,0.004650053653910808,39
فلامي,2018-11-28,8374,8387,0.001552424169864769,13
فلامي,2018-12-01,8356,8374,0.002154140736937034,18
فلامي,2018-12-02,7939,8356,0.05252550698418875,417
فلامي,2018-12-03,7940,7939,1.259445843670095e-4,1
فلامي,2018-12-04,7940,7940,0,0
فلامي,2018-12-08,8337,7940,0.047619047613335845,397
فلامي,2018-12-09,8337,8337,0,0
فلامي,2018-12-10,8338,8337,1.1993283759655398e-4,1
فلامي,2018-12-11,8339,8338,1.1991845543591336e-4,1
فلامي,2018-12-12,8396,8339,0.0067889471168664905,57
فلامي,2018-12-16,8391,8396,5.958765343110623e-4,5
فلامي,2018-12-17,8371,8391,0.002389200812042862,20
فلامي,2018-12-19,8401,8371,0.0035710034515449344,30
فلامي,2018-12-22,8401,8401,0,0
فلامي,2018-12-24,8386,8401,0.0017886954445756385,15
فلامي,2018-12-25,8375,8386,0.0013134328356640677,11
فلامي,2018-12-26,8396,8375,0.0025011910430560755,21
فلامي,2018-12-29,8397,8396,1.190901512303096e-4,1
فلامي,2018-12-30,8397,8397,0,0
فلامي,2019-01-01,8783,8397,0.04394853694136985,386
فلامي,2019-01-02,8762,8783,0.002396713078932126,21
فلامي,2019-01-05,8723,8762,0.004470938896655859,39
فلامي,2019-01-06,8722,8723,1.1465260260093412e-4,1
فلامي,2019-01-07,8722,8722,0,0
فلامي,2019-01-09,8931,8722,0.023401634752726275,209
فلامي,2019-01-16,8570,8931,0.04212368727629828,361
فلامي,2019-01-20,8350,8570,0.02634730538606619,220
فلامي,2019-01-21,8375,8350,0.0029850746265092445,25
فلامي,2019-01-22,8394,8375,0.002263521562751546,19
فلامي,2019-01-23,8478,8394,0.009907997167974993,84
فلامي,2019-01-26,8479,8478,1.1793843612242735e-4,1
فلامي,2019-01-27,8515,8479,0.004227833234970307,36
فلامي,2019-01-28,8839,8515,0.03665573028208443,324
فلامي,2019-01-29,9213,8839,0.04059481167474278,374
فلامي,2019-01-30,9673,9213,0.04755505013464747,460
فلامي,2019-02-02,10140,9673,0.046055226819915654,467
فلامي,2019-02-03,10647,10140,0.04761904761457508,507
فلامي,2019-02-04,11750,10647,0.09387234041754278,1103
فلامي,2019-02-05,12337,11750,0.04758044905182942,587
فلامي,2019-02-06,12953,12337,0.047556550602365744,616
فلامي,2019-02-10,13371,12953,0.03126168573545272,418
فلامي,2019-02-12,14039,13371,0.047581736587536026,668
فلامي,2019-02-13,14740,14039,0.047557666211156195,701
فلامي,2019-02-16,15448,14740,0.04583117555373956,708
فلامي,2019-02-17,16203,15448,0.046596309322557775,755
فلامي,2019-02-18,15608,16203,0.03812147616362625,595
فلامي,2019-02-19,15024,15608,0.03887113950752988,584
فلامي,2019-02-20,14488,15024,0.036996134729638586,536
فلامي,2019-02-23,14235,14488,0.017773094484174704,253
فلامي,2019-02-24,13553,14235,0.05032096214488888,682
فلامي,2019-02-25,13545,13553,5.906238463941954e-4,8
فلامي,2019-02-26,13213,13545,0.025126769089145025,332
فلامي,2019-02-27,13753,13213,0.03926416054393484,540
فلامي,2019-03-02,14024,13753,0.019324015971240442,271
فلامي,2019-03-03,13414,14024,0.045474876990795075,610
فلامي,2019-03-04,13232,13414,0.01375453446087103,182
فلامي,2019-03-05,13232,13232,0,0
فلامي,2019-03-06,12649,13232,0.046090600043790765,583
فلامي,2019-03-09,12767,12649,0.009242578522030032,118
فلامي,2019-03-10,13205,12767,0.033169254067915994,438
فلامي,2019-03-11,13865,13205,0.04760187522195443,660
فلامي,2019-03-12,14153,13865,0.020349042604370166,288
فلامي,2019-03-13,14053,14153,0.007115918308751447,100
فلامي,2019-03-16,13890,14053,0.011735061194259535,163
فلامي,2019-03-17,13246,13890,0.0486184508494173,644
فلامي,2019-03-18,13265,13246,0.0014323407462169362,19
فلامي,2019-03-19,13848,13265,0.04209994222688475,583
فلامي,2019-03-25,13292,13848,0.041829671980000774,556
فلامي,2019-03-26,13643,13292,0.025727479291524774,351
فلامي,2019-03-27,14039,13643,0.02820713725847944,396
فلامي,2019-03-30,14739,14039,0.04749304565794877,700
فلامي,2019-03-31,15292,14739,0.03616269944832836,553
فلامي,2019-04-06,15107,15292,0.012245978684567022,185
فلامي,2019-04-07,15686,15107,0.03691189595582609,579
فلامي,2019-04-08,15644,15686,0.0026847353616284366,42
فلامي,2019-04-09,15704,15644,0.003820682628386355,60
فلامي,2019-04-10,16093,15704,0.024172000247053252,389
فلامي,2019-04-13,16229,16093,0.008380060385212886,136
فلامي,2019-04-14,16579,16229,0.021111044090650156,350
فلامي,2019-04-15,17407,16579,0.04756707071594375,828
فلامي,2019-04-16,18047,17407,0.03546295783036167,640
فلامي,2019-04-17,17860,18047,0.010470324747454069,187
فلامي,2019-04-20,17493,17860,0.020979820498429096,367
فلامي,2019-04-22,17520,17493,0.0015410958903229967,27
فلامي,2019-04-23,17711,17520,0.010784258369895305,191
فلامي,2019-04-24,17104,17711,0.03548877455358461,607
فلامي,2019-04-27,16878,17104,0.013390212109646272,226
فلامي,2019-04-28,16617,16878,0.01570680628177729,261
فلامي,2019-04-29,17052,16617,0.025510204080136628,435
فلامي,2019-04-30,17904,17052,0.04758713136463432,852
فلامي,2019-05-01,18799,17904,0.04760891536530619,895
فلامي,2019-05-04,19738,18799,0.047573209035992846,939
فلامي,2019-05-05,19958,19738,0.011023148611533062,220
فلامي,2019-05-06,19020,19958,0.04931650893536717,938
فلامي,2019-05-07,18147,19020,0.048107125142001037,873
فلامي,2019-05-08,19006,18147,0.04519625381220687,859
فلامي,2019-05-11,19672,19006,0.03385522569978369,666
فلامي,2019-05-12,18732,19672,0.0501815075779318,940
فلامي,2019-05-13,18358,18732,0.020372589605601232,374
فلامي,2019-05-14,18447,18358,0.004824632731347935,89
فلامي,2019-05-15,18824,18447,0.020027624308328325,377
فلامي,2019-05-18,19765,18824,0.04760941057183863,941
فلامي,2019-05-19,20742,19765,0.0471024973461044,977
فلامي,2019-05-20,21778,20742,0.04757094315145693,1036
فلامي,2019-05-21,21702,21778,0.003501981384042854,76
فلامي,2019-05-22,20706,21702,0.04810199941813474,996
فلامي,2019-05-25,19827,20706,0.044333484639918624,879
فلامي,2019-05-26,20441,19827,0.030037669388482086,614
فلامي,2019-05-28,21335,20441,0.04190297632801017,894
فلامي,2019-05-29,22282,21335,0.042500673187213865,947
فلامي,2019-06-01,22327,22282,0.00201549693187551,45
فلامي,2019-06-02,23272,22327,0.04060673770880858,945
فلامي,2019-06-03,24419,23272,0.04697162045755471,1147
فلامي,2019-06-08,25610,24419,0.04650527137655192,1191
فلامي,2019-06-09,26828,25610,0.04540032801381391,1218
فلامي,2019-06-10,27771,26828,0.03395628533239868,943
فلامي,2019-06-11,26569,27771,0.0452406940402258,1202
فلامي,2019-06-12,26907,26569,0.012561786895136515,338
فلامي,2019-06-15,26158,26907,0.02863368758969976,749
فلامي,2019-06-16,26943,26158,0.029135582524992185,785
فلامي,2019-06-17,26335,26943,0.023087146382263637,608
فلامي,2019-06-18,27510,26335,0.042711741183471034,1175
فلامي,2019-06-19,28859,27510,0.046744516440391404,1349
فلامي,2019-06-22,29112,28859,0.008690574333309612,253
فلامي,2019-06-23,30362,29112,0.04116988340553422,1250
فلامي,2019-06-24,30096,30362,0.008838383838090165,266
فلامي,2019-06-25,30151,30096,0.0018241517693667157,55
فلامي,2019-06-26,28823,30151,0.0460743156490971,1328
فلامي,2019-06-30,27767,28823,0.03803075593193248,1056
فلامي,2019-07-01,26474,27767,0.048840371683582365,1293
فلامي,2019-07-02,26489,26474,5.662727924585196e-4,15
فلامي,2019-07-03,25778,26489,0.02758165877773366,711
فلامي,2019-07-06,25353,25778,0.016763302172651626,425
فلامي,2019-07-07,26391,25353,0.03933159031338973,1038
فلامي,2019-07-08,27694,26391,0.04704990250425905,1303
فلامي,2019-07-09,27745,27694,0.0018381690394003183,51
فلامي,2019-07-10,27137,27745,0.022404834726668207,608
فلامي,2019-07-13,26803,27137,0.012461291645992564,334
فلامي,2019-07-14,27752,26803,0.03419573363958649,949
فلامي,2019-07-15,27756,27752,1.441129845747185e-4,4
فلامي,2019-07-16,27254,27756,0.018419314595346764,502
فلامي,2019-07-17,26447,27254,0.030513857903334447,807
فلامي,2019-07-20,25219,26447,0.048693445416206294,1228
فلامي,2019-07-21,25500,25219,0.011019607842705113,281
فلامي,2019-07-22,25958,25500,0.017643886277153714,458
فلامي,2019-07-23,26007,25958,0.0018841081246632019,49
فلامي,2019-07-24,25457,26007,0.021605059511269786,550
فلامي,2019-07-27,25946,25457,0.018846835735032496,489
فلامي,2019-07-28,25592,25946,0.013832447639346965,354
فلامي,2019-07-29,25417,25592,0.0068851556042457745,175
فلامي,2019-07-30,24976,25417,0.017656950671938784,441
فلامي,2019-07-31,26059,24976,0.04155953796993133,1083
فلامي,2019-08-03,27294,26059,0.045248039860582984,1235
فلامي,2019-08-04,28603,27294,0.04576443030291352,1309
فلامي,2019-08-05,28960,28603,0.012327348065872674,357
فلامي,2019-08-06,29450,28960,0.01663837011828053,490
فلامي,2019-08-07,28117,29450,0.047409040792139666,1333
فلامي,2019-08-10,28963,28117,0.029209681316534553,846
فلامي,2019-08-11,28501,28963,0.016209957544780534,462
فلامي,2019-08-13,28058,28501,0.015788723358194142,443
فلامي,2019-08-14,27949,28058,0.003899960642459481,109
فلامي,2019-08-17,27814,27949,0.004853670813085005,135
فلامي,2019-08-18,27815,27814,3.5951824553803635e-5,1
فلامي,2019-08-19,27648,27815,0.006040219907188939,167
فلامي,2019-08-21,27858,27648,0.007538229592665007,210
فلامي,2019-08-24,27944,27858,0.0030775837387962504,86
فلامي,2019-08-25,28589,27944,0.022561124907392312,645
فلامي,2019-08-26,29057,28589,0.016106273874931815,468
فلامي,2019-08-27,28898,29057,0.005502110872534358,159
فلامي,2019-08-28,27970,28898,0.033178405433207776,928
فلامي,2019-08-31,28205,27970,0.00833185605359575,235
فلامي,2019-09-01,28822,28205,0.02140725834357757,617
فلامي,2019-09-02,28476,28822,0.012150582946616428,346
فلامي,2019-09-03,28604,28476,0.0044748986154217974,128
فلامي,2019-09-04,29800,28604,0.040134228186572675,1196
فلامي,2019-09-07,31289,29800,0.04758860941392858,1489
فلامي,2019-09-08,32853,31289,0.047606002494517824,1564
فلامي,2019-09-11,34494,32853,0.04757349104054115,1641
فلامي,2019-09-14,34201,34494,0.008567000964633578,293
فلامي,2019-09-15,32635,34201,0.04798529186309222,1566
فلامي,2019-09-16,31874,32635,0.02387525883090057,761
فلامي,2019-09-17,31943,31874,0.0021600976739141564,69
فلامي,2019-09-18,30672,31943,0.041438445486390245,1271
فلامي,2019-09-21,30262,30672,0.013548344457948967,410
فلامي,2019-09-22,31587,30262,0.0419476366846504,1325
فلامي,2019-09-23,31230,31587,0.011431316041901014,357
فلامي,2019-09-24,29867,31230,0.045635651386291366,1363
فلامي,2019-09-25,30590,29867,0.023635174892983484,723
فلامي,2019-09-28,32116,30590,0.047515257191197056,1526
فلامي,2019-09-29,33721,32116,0.047596453247305937,1605
فلامي,2019-09-30,32830,33721,0.027139811147513255,891
فلامي,2019-10-01,31618,32830,0.03833259535586272,1212
فلامي,2019-10-02,30374,31618,0.0409560808572807,1244
فلامي,2019-10-05,31837,30374,0.04595282218657685,1463
فلامي,2019-10-06,32511,31837,0.02073144474114203,674
فلامي,2019-10-07,31318,32511,0.038093109392742415,1193
فلامي,2019-10-08,30607,31318,0.02322998006915967,711
فلامي,2019-10-09,29453,30607,0.03918106814113397,1154
فلامي,2019-10-12,28911,29453,0.018747189650349445,542
فلامي,2019-10-13,29434,28911,0.017768566962772014,523
فلامي,2019-10-14,27996,29434,0.051364480638256736,1438
فلامي,2019-10-15,27289,27996,0.02590787496698641,707
فلامي,2019-10-16,25960,27289,0.051194144836240595,1329
فلامي,2019-10-20,24703,25960,0.0508845079524396,1257
فلامي,2019-10-21,23469,24703,0.052579999145571606,1234
فلامي,2019-10-22,23761,23469,0.012289045073343333,292
فلامي,2019-10-23,23155,23761,0.026171453248707774,606
فلامي,2019-10-26,22194,23155,0.04329999098660449,961
فلامي,2019-10-28,22843,22194,0.02841132950889063,649
فلامي,2019-10-30,23940,22843,0.045822890557818595,1097
فلامي,2019-11-02,25137,23940,0.047619047617153236,1197
فلامي,2019-11-03,26393,25137,0.047588375703876466,1256
فلامي,2019-11-04,27709,26393,0.04749359413737437,1316
فلامي,2019-11-05,28482,27709,0.027139948036404047,773
فلامي,2019-11-09,27141,28482,0.04940864374748872,1341
فلامي,2019-11-10,25910,27141,0.047510613660844823,1231
فلامي,2019-11-11,26758,25910,0.03169145675941059,848
فلامي,2019-11-12,27970,26758,0.04333214157871533,1212
فلامي,2019-11-13,29236,27970,0.04330277739624768,1266
فلامي,2019-11-16,30621,29236,0.045230397438188484,1385
فلامي,2019-11-17,29452,30621,0.03969170175065558,1169
فلامي,2019-11-18,28209,29452,0.0440639512196794,1243
فلامي,2019-11-19,29581,28209,0.04638112301658561,1372
فلامي,2019-11-20,29602,29581,7.094115262242615e-4,21
فلامي,2019-11-23,28230,29602,0.04860077931106621,1372
فلامي,2019-11-24,27890,28230,0.012190749372097857,340
فلامي,2019-11-25,27978,27890,0.003145328472258727,88
فلامي,2019-11-26,29372,27978,0.047460166143011705,1394
فلامي,2019-11-27,28995,29372,0.013002241765373262,377
فلامي,2019-11-30,28390,28995,0.021310320534649162,605
فلامي,2019-12-01,28167,28390,0.007917066069942944,223
فلامي,2019-12-02,26993,28167,0.0434927573799321,1174
فلامي,2019-12-03,27382,26993,0.014206412971506596,389
فلامي,2019-12-04,28483,27382,0.038654636097368446,1101
فلامي,2019-12-07,29907,28483,0.04761427090488467,1424
فلامي,2019-12-08,30794,29907,0.02880431252747924,887
فلامي,2019-12-09,30618,30794,0.005748252661645168,176
فلامي,2019-12-10,31846,30618,0.03856057275517928,1228
فلامي,2019-12-11,33343,31846,0.04489697987448949,1497
فلامي,2019-12-14,35010,33343,0.047614967150882176,1667
فلامي,2019-12-15,36282,35010,0.03505870679579244,1272
فلامي,2019-12-16,37975,36282,0.044581961815810874,1693
فلامي,2019-12-17,39873,37975,0.04760113359798357,1898
فلامي,2019-12-18,41866,39873,0.047604261213213483,1993
فلامي,2019-12-21,43802,41866,0.04419889502661525,1936
فلامي,2019-12-24,44150,43802,0.007882219705370732,348
فلامي,2019-12-25,42816,44150,0.031156576979840325,1334
فلامي,2019-12-28,41502,42816,0.03166112476430868,1314
فلامي,2019-12-29,39835,41502,0.04184762143738301,1667
فلامي,2019-12-30,41609,39835,0.042635006848455025,1774
فلامي,2019-12-31,43500,41609,0.04347126436681675,1891
فلامي,2020-01-01,44945,43500,0.03215040605112581,1445
فلامي,2020-01-04,42698,44945,0.052625415709105214,2247
فلامي,2020-01-05,41264,42698,0.034751841798304775,1434
فلامي,2020-01-07,41433,41264,0.004078874327128644,169
فلامي,2020-01-08,40605,41433,0.02039157739144461,828
فلامي,2020-01-11,41417,40605,0.019605476011792126,812
فلامي,2020-01-12,43487,41417,0.04760043231201048,2070
فلامي,2020-01-13,45659,43487,0.04757003000399549,2172
فلامي,2020-01-14,47362,45659,0.03595709640564256,1703
فلامي,2020-01-19,48659,47362,0.026654883988025752,1297
فلامي,2020-01-20,50865,48659,0.04336970411789306,2206
فلامي,2020-01-21,53028,50865,0.04078977144073339,2163
فلامي,2020-01-22,54467,53028,0.026419666953817547,1439
فلامي,2020-01-25,53687,54467,0.01452865684403061,780
فلامي,2020-01-26,51734,53687,0.03775080217965456,1953
فلامي,2020-01-27,51910,51734,0.0033904835291198136,176
فلامي,2020-01-28,52426,51910,0.009842444588375188,516
فلامي,2020-02-01,50789,52426,0.032231388685891996,1637
فلامي,2020-02-02,48881,50789,0.03903357132548365,1908
فلامي,2020-02-03,51268,48881,0.04655925723557464,2387
فلامي,2020-02-04,52283,51268,0.019413576114235723,1015
فلامي,2020-02-05,53764,52283,0.02754631351782705,1481
فلامي,2020-02-08,51785,53764,0.03821569952615206,1979
فلامي,2020-02-09,51763,51785,4.250140061351735e-4,22
فلامي,2020-02-10,50320,51763,0.028676470587665412,1443
فلامي,2020-02-12,52192,50320,0.035867565909797144,1872
فلامي,2020-02-15,54115,52192,0.03553543379773565,1923
فلامي,2020-02-16,56785,54115,0.04701945936344071,2670
فلامي,2020-02-17,59462,56785,0.04502034912978002,2677
فلامي,2020-02-18,62204,59462,0.04408076650948362,2742
فلامي,2020-02-19,63733,62204,0.023990711248113368,1529
فلامي,2020-02-22,65882,63733,0.032618924743744594,2149
فلامي,2020-02-23,69173,65882,0.047576366500692815,3291
فلامي,2020-02-24,72595,69173,0.047138232660002236,3422
فلامي,2020-02-25,76217,72595,0.047522206331297195,3622
فلامي,2020-02-26,80026,76217,0.04759703096434163,3809
فلامي,2020-03-02,80381,80026,0.0044164665778677,355
فلامي,2020-03-03,79397,80381,0.012393415368182762,984
فلامي,2020-03-04,78742,79397,0.008318305351549132,655
فلامي,2020-03-07,78554,78742,0.002393258140866242,188
فلامي,2020-03-09,78475,78554,0.0010066900286587234,79
فلامي,2020-03-10,78389,78475,0.0010970927043195207,86
فلامي,2020-03-11,75210,78389,0.04226831538303061,3179
فلامي,2020-03-14,74095,75210,0.015048248869491219,1115
فلامي,2020-03-15,73433,74095,0.009015020494750113,662
فلامي,2020-03-16,73469,73433,4.900025861180906e-4,36
فلامي,2020-03-17,72199,73469,0.017590271333154335,1270
فلامي,2020-03-18,72759,72199,0.007696642339673489,560
فلامي,2020-03-24,73532,72759,0.010512429962322357,773
فلامي,2020-03-25,75068,73532,0.020461448286613986,1536
فلامي,2020-03-28,77223,75068,0.02790619375020517,2155
فلامي,2020-03-29,78241,77223,0.013011081146547067,1018
فلامي,2020-03-30,78880,78241,0.008100912778801967,639
فلامي,2020-04-04,80606,78880,0.021412798054469735,1726
فلامي,2020-04-05,81622,80606,0.012447624414833653,1016
فلامي,2020-04-06,81951,81622,0.004014594086661364,329
فلامي,2020-04-07,82272,81951,0.0039016919486106858,321
فلامي,2020-04-08,81052,82272,0.015052065340583181,1220
فلامي,2020-04-11,78958,81052,0.026520428581948374,2094
فلامي,2020-04-12,76202,78958,0.0361670297362777,2756
فلامي,2020-04-13,75216,76202,0.013108912997060348,986
فلامي,2020-04-14,74224,75216,0.013364949342350657,992
فلامي,2020-04-15,74572,74224,0.00466663090698028,348
فلامي,2020-04-18,76024,74572,0.019099231821278817,1452
فلامي,2020-04-19,75660,76024,0.004810996563510296,364
فلامي,2020-04-20,75250,75660,0.0054485049833163,410
فلامي,2020-04-21,74604,75250,0.008659053133764154,646
فلامي,2020-04-22,73881,74604,0.009786007227706908,723
فلامي,2020-04-25,77065,73881,0.04131577239938603,3184
فلامي,2020-04-26,77036,77065,3.764473752482418e-4,29
فلامي,2020-04-27,75264,77036,0.023543792516693987,1772
فلامي,2020-04-28,74283,75264,0.013206251766713702,981
فلامي,2020-04-29,77790,74283,0.04508291554126388,3507
فلامي,2020-05-02,79123,77790,0.016847187290461092,1333
فلامي,2020-05-03,82567,79123,0.04171157968629463,3444
فلامي,2020-05-04,84507,82567,0.022956678144734087,1940
فلامي,2020-05-05,87314,84507,0.0321483381813667,2807
فلامي,2020-05-06,89284,87314,0.022064423636686703,1970
فلامي,2020-05-09,93576,89284,0.04586646148536092,4292
فلامي,2020-05-10,92523,93576,0.011380953924847002,1053
فلامي,2020-05-11,91746,92523,0.00846903407223782,777
فلامي,2020-05-12,91323,91746,0.004631910909577742,423
فلامي,2020-05-13,87856,91323,0.03946230194819407,3467
فلامي,2020-05-16,86286,87856,0.01819530398884877,1570
فلامي,2020-05-17,85469,86286,0.009559021399459933,817
فلامي,2020-05-18,82544,85469,0.03543564644267984,2925
فلامي,2020-05-19,83620,82544,0.012867734991474915,1076
فلامي,2020-05-20,85964,83620,0.027267228141695743,2344
فلامي,2020-05-23,87098,85964,0.01301981675798503,1134
فلامي,2020-05-26,90466,87098,0.037229456369937554,3368
فلامي,2020-05-27,89691,90466,0.008640777781397902,775
فلامي,2020-05-30,89367,89691,0.003625499345355383,324
فلامي,2020-05-31,86628,89367,0.031617952624652335,2739
فلامي,2020-06-01,86105,86628,0.006073979443631915,523
فلامي,2020-06-02,85035,86105,0.012583054036425201,1070
فلامي,2020-06-06,85701,85035,0.007771204536612512,666
فلامي,2020-06-07,88192,85701,0.02824519230737204,2491
فلامي,2020-06-08,88650,88192,0.005166384658712168,458
فلامي,2020-06-09,87325,88650,0.015173203549783302,1325
فلامي,2020-06-10,86379,87325,0.010951735954213967,946
فلامي,2020-06-13,86930,86379,0.006338433222059837,551
فلامي,2020-06-14,86130,86930,0.009288285150246276,800
فلامي,2020-06-15,85690,86130,0.005134788189927241,440
فلامي,2020-06-16,88320,85690,0.029778079709807767,2630
فلامي,2020-06-20,90830,88320,0.027634041615901862,2510
فلامي,2020-06-21,94690,90830,0.04076460027414971,3860
فلامي,2020-06-22,97830,94690,0.032096493917692974,3140
فلامي,2020-06-23,102610,97830,0.04658415359081392,4780
فلامي,2020-06-24,105340,102610,0.025916081260433682,2730
فلامي,2020-06-27,106910,105340,0.014685249274953838,1570
فلامي,2020-06-28,109280,106910,0.021687408491748834,2370
فلامي,2020-06-29,109180,109280,9.159186664140327e-4,100
فلامي,2020-06-30,111590,109180,0.02159691728630167,2410
فلامي,2020-07-01,114440,111590,0.024903879762103252,2850
فلامي,2020-07-04,112220,114440,0.01978256995170395,2220
فلامي,2020-07-05,115700,112220,0.030077787380898207,3480
فلامي,2020-07-06,119130,115700,0.02879207588324694,3430
فلامي,2020-07-07,118990,119130,0.0011765694596085675,140
فلامي,2020-07-08,123930,118990,0.03986121197418009,4940
فلامي,2020-07-11,126120,123930,0.01736441484286898,2190
فلامي,2020-07-12,127490,126120,0.01074594085802223,1370
فلامي,2020-07-13,128580,127490,0.008477212630203164,1090
فلامي,2020-07-14,130340,128580,0.013503145619046317,1760
فلامي,2020-07-15,132120,130340,0.013472600665959183,1780
فلامي,2020-07-18,134100,132120,0.014765100671030833,1980
فلامي,2020-07-19,139810,134100,0.04084114154895328,5710
فلامي,2020-07-20,142680,139810,0.02011494252859465,2870
فلامي,2020-07-21,144210,142680,0.010609527771925597,1530
فلامي,2020-07-22,146070,144210,0.012733620866620568,1860
فلامي,2020-07-25,148710,146070,0.01775267298757479,2640
فلامي,2020-07-26,151550,148710,0.01873968987120594,2840
فلامي,2020-07-27,153440,151550,0.012317518248094905,1890
فلامي,2020-07-28,155460,153440,0.01299369612753767,2020
فلامي,2020-07-29,149640,155460,0.03889334402540167,5820
فلامي,2020-08-01,142710,149640,0.04856001681698157,6930
فلامي,2020-08-02,139310,142710,0.02440600100477779,3400
فلامي,2020-08-03,133530,139310,0.04328615292411229,5780
فلامي,2020-08-04,140200,133530,0.047574893009646395,6670
فلامي,2020-08-05,143450,140200,0.022655977692417874,3250
فلامي,2020-08-09,145520,143450,0.014224848817934134,2070
فلامي,2020-08-10,144480,145520,0.0071982281284108645,1040
فلامي,2020-08-11,143950,144480,0.0036818339701029396,530
فلامي,2020-08-12,143070,143950,0.006150835255426358,880
فلامي,2020-08-15,142780,143070,0.002031096792253599,290
فلامي,2020-08-16,142540,142780,0.0016837378981220447,240
فلامي,2020-08-17,142330,142540,0.0014754443897879894,210
فلامي,2020-08-18,141630,142330,0.004942455694380128,700
فلامي,2020-08-19,141530,141630,7.065639793633395e-4,100
فلامي,2020-08-22,141200,141530,0.0023371104815698503,330
فلامي,2020-08-23,141160,141200,2.833663927438129e-4,40
فلامي,2020-08-24,141130,141160,2.1256997094726442e-4,30
فلامي,2020-08-25,140680,141130,0.0031987489337276173,450
فلامي,2020-08-26,135760,140680,0.03624042427787094,4920
فلامي,2020-08-31,129740,135760,0.04640049329392323,6020
فلامي,2020-09-01,127510,129740,0.017488824405791793,2230
فلامي,2020-09-02,127230,127510,0.002200738819443522,280
فلامي,2020-09-05,122900,127230,0.03523189584999811,4330
فلامي,2020-09-06,122610,122900,0.002365223064983564,290
فلامي,2020-09-07,122490,122610,9.79671809935671e-4,120
فلامي,2020-09-08,122460,122490,2.4497795198232095e-4,30
فلامي,2020-09-09,122200,122460,0.0021276595744506737,260
قصفها,2018-01-15,8341,8431,0.01079007313142428,90
قصفها,2018-01-16,8196,8341,0.017691556854844855,145
قصفها,2018-01-17,8408,8196,0.02521408182383277,212
قصفها,2018-01-20,8790,8408,0.04345847553544272,382
قصفها,2018-01-21,8843,8790,0.005993441139206893,53
قصفها,2018-01-22,8773,8843,0.007979026557850332,70
قصفها,2018-01-23,8843,8773,0.007915865655556274,70
قصفها,2018-01-24,9088,8843,0.02695862675759698,245
قصفها,2018-01-27,8795,9088,0.03331438316846908,293
قصفها,2018-01-28,8768,8795,0.003079379561692589,27
قصفها,2018-01-29,8596,8768,0.020009306651930046,172
قصفها,2018-01-30,8639,8596,0.004977427942472806,43
قصفها,2018-01-31,8678,8639,0.004494123069313883,39
قصفها,2018-02-03,8610,8678,0.00789779326272964,68
قصفها,2018-02-04,8690,8610,0.009205983888468817,80
قصفها,2018-02-05,8806,8690,0.013172836700752573,116
قصفها,2018-02-06,8779,8806,0.0030755211296189175,27
قصفها,2018-02-07,8805,8779,0.0029528676884778117,26
قصفها,2018-02-10,8847,8805,0.004747371989968648,42
قصفها,2018-02-12,8859,8847,0.0013545546899927131,12
قصفها,2018-02-13,8804,8859,0.0062471603809351245,55
قصفها,2018-02-14,8709,8804,0.01090825582605256,95
قصفها,2018-02-17,8689,8709,0.0023017608467830863,20
قصفها,2018-02-18,8572,8689,0.013649090059070335,117
قصفها,2018-02-19,8535,8572,0.004335090802069702,37
قصفها,2018-02-21,8523,8535,0.0014079549452765512,12
قصفها,2018-02-24,8416,8523,0.012713878325485518,107
قصفها,2018-02-25,8263,8416,0.018516277378855587,153
قصفها,2018-02-26,8204,8263,0.007191613846027351,59
قصفها,2018-02-27,8215,8204,0.0013390139986197182,11
قصفها,2018-02-28,8214,8215,1.2174336497178678e-4,1
قصفها,2018-03-03,8177,8214,0.004524886877274687,37
قصفها,2018-03-04,8046,8177,0.016281382051170596,131
قصفها,2018-03-05,8001,8046,0.005624296962176691,45
قصفها,2018-03-06,7912,8001,0.011248736095646014,89
قصفها,2018-03-11,8051,7912,0.01726493603064651,139
قصفها,2018-03-12,8086,8051,0.004328468958158735,35
قصفها,2018-03-13,7960,8086,0.015829145726654628,126
قصفها,2018-03-14,8004,7960,0.00549725137362603,44
قصفها,2018-03-17,8037,8004,0.00410600970460296,33
قصفها,2018-03-18,8096,8037,0.007287549406214482,59
قصفها,2018-03-19,8156,8096,0.007356547326219157,60
قصفها,2018-03-25,8157,8156,1.2259409094978618e-4,1
قصفها,2018-03-26,8156,8157,1.2260912210365263e-4,1
قصفها,2018-03-27,8150,8156,7.36196318928074e-4,6
قصفها,2018-03-28,8141,8150,0.0011055152928257565,9
قصفها,2018-04-03,8213,8141,0.008766589552080045,72
قصفها,2018-04-04,8235,8213,0.0026715239826749816,22
قصفها,2018-04-07,8220,8235,0.0018248175180261778,15
قصفها,2018-04-08,8111,8220,0.013438540252319253,109
قصفها,2018-04-09,8107,8111,4.934007647103243e-4,4
قصفها,2018-04-10,8373,8107,0.03176878060052923,266
قصفها,2018-04-11,8420,8373,0.005581947742804994,47
قصفها,2018-04-15,8448,8420,0.0033143939390016105,28
قصفها,2018-04-16,8851,8448,0.04553157834758428,403
قصفها,2018-04-17,9224,8851,0.04043798785337836,373
قصفها,2018-04-18,9641,9224,0.04325277460395677,417
قصفها,2018-04-21,9812,9641,0.017427639623172887,171
قصفها,2018-04-22,9489,9812,0.03403941405479614,323
قصفها,2018-04-23,9507,9489,0.001893341747986395,18
قصفها,2018-04-24,9394,9507,0.012028954650624977,113
قصفها,2018-04-25,9384,9394,0.0010656436486502936,10
قصفها,2018-04-28,9505,9384,0.012730142029170947,121
قصفها,2018-04-29,9300,9505,0.022043010750317955,205
قصفها,2018-04-30,9205,9300,0.010320477999965183,95
قصفها,2018-05-01,9208,9205,3.258036489654861e-4,3
قصفها,2018-05-05,9247,9208,0.0042175840808675695,39
قصفها,2018-05-06,9217,9247,0.003254855158592291,30
قصفها,2018-05-07,9174,9217,0.004687159362907438,43
قصفها,2018-05-08,9295,9174,0.013017751477889429,121
قصفها,2018-05-09,9234,9295,0.006606021225188865,61
قصفها,2018-05-12,9651,9234,0.04320795772011108,417
قصفها,2018-05-13,9692,9651,0.004230293024738929,41
قصفها,2018-05-14,9643,9692,0.005081406200862656,49
قصفها,2018-05-15,9895,9643,0.025467407779134168,252
قصفها,2018-05-16,10058,9895,0.016206005168402662,163
قصفها,2018-05-19,9785,10058,0.0278998467012877,273
قصفها,2018-05-20,9703,9785,0.008450994536900855,82
قصفها,2018-05-21,9921,9703,0.02197359136962266,218
قصفها,2018-05-22,9449,9921,0.04995237590750848,472
قصفها,2018-05-23,9490,9449,0.004320337196594274,41
قصفها,2018-05-26,9527,9490,0.003883698960440464,37
قصفها,2018-05-27,9512,9527,0.001576955424560875,15
قصفها,2018-05-28,9362,9512,0.016022217473187116,150
قصفها,2018-05-29,9182,9362,0.01960357220435596,180
قصفها,2018-05-30,9156,9182,0.002839667976972513,26
قصفها,2018-06-02,9143,9156,0.0014218527833947442,13
قصفها,2018-06-03,9388,9143,0.02609714528908211,245
قصفها,2018-06-11,8316,9388,0.12890812889262768,1072
قصفها,2018-06-12,8416,8316,0.01188212927615469,100
قصفها,2018-06-13,8612,8416,0.022758941009897938,196
قصفها,2018-06-17,8911,8612,0.03355403433581483,299
قصفها,2018-06-18,8565,8911,0.040396964385242616,346
قصفها,2018-06-19,8638,8565,0.008451030330116805,73
قصفها,2018-06-20,8666,8638,0.0032310177702248996,28
قصفها,2018-06-23,8697,8666,0.0035644475102260035,31
قصفها,2018-06-24,8538,8697,0.018622628247994537,159
قصفها,2018-06-25,8534,8538,4.6871338171212637e-4,4
قصفها,2018-06-26,8670,8534,0.015686274507994664,136
قصفها,2018-06-27,8611,8670,0.006851701311479305,59
قصفها,2018-06-30,8544,8611,0.007841760298707659,67
قصفها,2018-07-01,8459,8544,0.010048469084992497,85
قصفها,2018-07-02,8329,8459,0.015608116218560677,130
قصفها,2018-07-03,8375,8329,0.0054925373127770105,46
قصفها,2018-07-04,8295,8375,0.009644364073581149,80
قصفها,2018-07-07,8361,8295,0.007893792607595528,66
قصفها,2018-07-08,8352,8361,0.0010775862067675303,9
قصفها,2018-07-10,8041,8352,0.038676781490029004,311
قصفها,2018-07-11,8024,8041,0.002118644067532572,17
قصفها,2018-07-14,8034,8024,0.0012447099824191299,10
قصفها,2018-07-15,8037,8034,3.7327360950936e-4,3
قصفها,2018-07-16,8038,8037,1.244090569638705e-4,1
قصفها,2018-07-17,8166,8038,0.01567474895717919,128
قصفها,2018-07-18,8087,8166,0.00976876468285288,79
قصفها,2018-07-21,8204,8087,0.014261335931952543,117
قصفها,2018-07-22,8367,8204,0.019481295563585358,163
قصفها,2018-07-23,8213,8367,0.01875076098639343,154
قصفها,2018-07-24,7993,8213,0.027524083569682962,220
قصفها,2018-07-25,7909,7993,0.010620811732125323,84
قصفها,2018-07-28,7957,7909,0.006032424279749601,48
قصفها,2018-07-29,7573,7957,0.05070645714370706,384
قصفها,2018-07-30,7477,7573,0.012839374078796392,96
قصفها,2018-07-31,7817,7477,0.043494946905015354,340
قصفها,2018-08-01,8175,7817,0.043792048924306784,358
قصفها,2018-08-04,8523,8175,0.04083069341301998,348
قصفها,2018-08-05,8325,8523,0.02378378378092687,198
قصفها,2018-08-06,8040,8325,0.035447761189620924,285
قصفها,2018-08-07,8132,8040,0.011313330052716019,92
قصفها,2018-08-08,8031,8132,0.012576266963942689,101
قصفها,2018-08-11,8183,8031,0.01857509470627214,152
قصفها,2018-08-12,8152,8183,0.0038027477914864146,31
قصفها,2018-08-13,8107,8152,0.005550758602991149,45
قصفها,2018-08-14,7966,8107,0.017700225958109436,141
قصفها,2018-08-15,8101,7966,0.016664609305435795,135
قصفها,2018-08-18,8376,8101,0.032831900664657125,275
قصفها,2018-08-19,8308,8376,0.008184882040420692,68
قصفها,2018-08-20,8021,8308,0.03578107467450679,287
قصفها,2018-08-21,8039,8021,0.002239084462963169,18
قصفها,2018-08-25,8188,8039,0.018197361990938278,149
قصفها,2018-08-26,8588,8188,0.04657661853207072,400
قصفها,2018-08-27,8520,8588,0.007981220656340233,68
قصفها,2018-08-28,8511,8520,0.0010574550580357825,9
قصفها,2018-08-29,8493,8511,0.0021193924405840817,18
قصفها,2018-09-01,8712,8493,0.02513774104394654,219
قصفها,2018-09-02,8679,8712,0.0038022813683831914,33
قصفها,2018-09-03,8638,8679,0.004746469089517658,41
قصفها,2018-09-04,8680,8638,0.0048387096768619,42
قصفها,2018-09-05,9080,8680,0.04405286343127171,400
قصفها,2018-09-08,9534,9080,0.04761904761405296,454
قصفها,2018-09-09,9999,9534,0.04650465046039557,465
قصفها,2018-09-10,10498,9999,0.047532863398025066,499
قصفها,2018-09-11,11312,10498,0.07195898160608566,814
قصفها,2018-09-12,11653,11312,0.029262850765531378,341
قصفها,2018-09-15,12132,11653,0.03948236069572351,479
قصفها,2018-09-16,11707,12132,0.03630306653828452,425
قصفها,2018-09-17,12280,11707,0.04666123778121651,573
قصفها,2018-09-18,12769,12280,0.03829587281397949,489
قصفها,2018-09-24,14063,12769,0.09201450614434939,1294
قصفها,2018-09-25,14752,14063,0.04670553145019621,689
قصفها,2018-09-26,15472,14752,0.04653567734962929,720
قصفها,2018-09-29,16235,15472,0.04699722820776118,763
قصفها,2018-09-30,16877,16235,0.03803993600533034,642
قصفها,2018-10-01,16485,16877,0.023779193204502322,392
قصفها,2018-10-02,16349,16485,0.008318551592860815,136
قصفها,2018-10-03,15532,16349,0.052601081634522207,817
قصفها,2018-10-06,14756,15532,0.05258877744289856,776
قصفها,2018-10-07,14706,14756,0.003399972799986402,50
قصفها,2018-10-08,14632,14706,0.005057408419555945,74
قصفها,2018-10-09,14567,14632,0.004462140454145525,65
قصفها,2018-10-10,14567,14567,0,0
قصفها,2018-10-13,14430,14567,0.009494109493451551,137
قصفها,2018-10-15,13794,14430,0.046107003041459545,636
قصفها,2018-10-16,13243,13794,0.04160688665396006,551
قصفها,2018-10-17,12588,13243,0.05203368286844346,655
قصفها,2018-10-20,12800,12588,0.016562499998706053,212
قصفها,2018-10-21,13107,12800,0.02342259860964198,307
قصفها,2018-10-22,13025,13107,0.0062955854121846,82
قصفها,2018-10-23,12606,13025,0.03323814056534681,419
قصفها,2018-10-24,12149,12606,0.03761626471004887,457
قصفها,2018-10-27,11558,12149,0.05113341408105784,591
قصفها,2018-10-28,11680,11558,0.010445205478557772,122
قصفها,2018-10-29,12052,11680,0.030866246263618797,372
قصفها,2018-10-31,11660,12052,0.03361921097481825,392
قصفها,2018-11-03,11688,11660,0.0023956194385356244,28
قصفها,2018-11-04,11734,11688,0.003920231804676987,46
قصفها,2018-11-05,11779,11734,0.0038203582643840427,45
قصفها,2018-11-11,11583,11779,0.01692135025322271,196
قصفها,2018-11-12,11818,11583,0.01988492130479904,235
قصفها,2018-11-13,12368,11818,0.044469598961475613,550
قصفها,2018-11-14,12984,12368,0.04744300677391844,616
قصفها,2018-11-17,12676,12984,0.024297885766464352,308
قصفها,2018-11-18,12122,12676,0.0457020293643209,554
قصفها,2018-11-19,12121,12122,8.250144376845958e-5,1
قصفها,2018-11-20,12024,12121,0.008067198934791483,97
قصفها,2018-11-21,12022,12024,1.6636167025733142e-4,2
قصفها,2018-11-24,11961,12022,0.0050999080340189025,61
قصفها,2018-11-26,11615,11961,0.02978906586054334,346
قصفها,2018-11-27,11581,11615,0.0029358431911807406,34
قصفها,2018-11-28,11391,11581,0.016679834955958227,190
قصفها,2018-12-01,11214,11391,0.015783841625130742,177
قصفها,2018-12-02,11164,11214,0.004478681475772243,50
قصفها,2018-12-03,11467,11164,0.02642365047297256,303
قصفها,2018-12-04,11468,11467,8.719916288043257e-5,1
قصفها,2018-12-05,11499,11468,0.002695886598600236,31
قصفها,2018-12-08,11430,11499,0.006036745406295997,69
قصفها,2018-12-09,11326,11430,0.009182412148226874,104
قصفها,2018-12-10,11188,11326,0.012334644260606485,138
قصفها,2018-12-11,11155,11188,0.0029583146568392367,33
قصفها,2018-12-12,11711,11155,0.04747673127423134,556
قصفها,2018-12-15,11842,11711,0.01106232055302632,131
قصفها,2018-12-16,11278,11842,0.05000886681592402,564
قصفها,2018-12-17,10874,11278,0.03715284163719396,404
قصفها,2018-12-18,11414,10874,0.04731032065469508,540
قصفها,2018-12-19,11916,11414,0.042128230946447784,502
قصفها,2018-12-22,12121,11916,0.016912795972534214,205
قصفها,2018-12-23,12263,12121,0.011579548233582357,142
قصفها,2018-12-24,12118,12263,0.01196567090180181,145
قصفها,2018-12-25,11814,12118,0.025732182154585052,304
قصفها,2018-12-26,12136,11814,0.0265326301889805,322
قصفها,2018-12-29,11994,12136,0.011839252958826142,142
قصفها,2018-12-30,12149,11994,0.012758251706909354,155
قصفها,2018-12-31,12752,12149,0.04728670012176234,603
قصفها,2019-01-01,13349,12752,0.04472245111658383,597
قصفها,2019-01-02,13197,13349,0.01151776918909466,152
قصفها,2019-01-05,13176,13197,0.001593806921554811,21
قصفها,2019-01-06,13353,13176,0.013255448212891825,177
قصفها,2019-01-07,12989,13353,0.028023712369849588,364
قصفها,2019-01-08,12683,12989,0.02412678388203684,306
قصفها,2019-01-09,13301,12683,0.04646267197605724,618
قصفها,2019-01-12,13087,13301,0.01635210514125834,214
قصفها,2019-01-13,12920,13087,0.012925696593426803,167
قصفها,2019-01-14,12816,12920,0.008114856428829989,104
قصفها,2019-01-15,12575,12816,0.019165009938833796,241
قصفها,2019-01-16,12397,12575,0.014358312493800249,178
قصفها,2019-01-19,12274,12397,0.010021182987614372,123
قصفها,2019-01-20,12550,12274,0.021992031870757607,276
قصفها,2019-01-21,12384,12550,0.013404392763775485,166
قصفها,2019-01-22,12385,12384,8.074283406695657e-5,1
قصفها,2019-01-23,12599,12385,0.016985475036353243,214
قصفها,2019-01-26,12902,12599,0.023484731047629458,303
قصفها,2019-01-27,12842,12902,0.004672169443648016,60
قصفها,2019-01-28,12800,12842,0.0032812499997436524,42
قصفها,2019-01-29,12664,12800,0.010739102968198112,136
قصفها,2019-01-30,12632,12664,0.0025332488915030676,32
قصفها,2019-02-02,12667,12632,0.002763085181750763,35
قصفها,2019-02-03,12577,12667,0.007155919535091364,90
قصفها,2019-02-04,12525,12577,0.004151696606454954,52
قصفها,2019-02-05,12531,12525,4.788125448504658e-4,6
قصفها,2019-02-06,12578,12531,0.003736683097174695,47
قصفها,2019-02-10,12582,12578,3.179144809793423e-4,4
قصفها,2019-02-12,12584,12582,1.5893197710116562e-4,2
قصفها,2019-02-13,12506,12584,0.006237006236507516,78
قصفها,2019-02-16,12439,12506,0.005386285070714182,67
قصفها,2019-02-17,12695,12439,0.020165419454890473,256
قصفها,2019-02-18,13327,12695,0.04742252569614898,632
قصفها,2019-02-19,13993,13327,0.04759522618111947,666
قصفها,2019-02-20,14692,13993,0.0475769126022613,699
قصفها,2019-02-23,15355,14692,0.043178117874101064,663
قصفها,2019-02-24,14655,15355,0.047765267823421,700
قصفها,2019-02-25,15288,14655,0.04140502354517236,633
قصفها,2019-02-26,15452,15288,0.010613512813188357,164
قصفها,2019-02-27,14826,15452,0.042223121540386946,626
قصفها,2019-03-02,14751,14826,0.005084401057210738,75
قصفها,2019-03-03,15475,14751,0.04678513731523198,724
قصفها,2019-03-04,16100,15475,0.038819875773986344,625
قصفها,2019-03-05,16239,16100,0.00855964037141698,139
قصفها,2019-03-06,16282,16239,0.002640953199690397,43
قصفها,2019-03-09,15484,16282,0.05153707052108389,798
قصفها,2019-03-10,15103,15484,0.02522677613552097,381
قصفها,2019-03-11,14897,15103,0.013828287573751206,206
قصفها,2019-03-12,14301,14897,0.041675407311259675,596
قصفها,2019-03-13,14090,14301,0.014975159686658966,211
قصفها,2019-03-16,14156,14090,0.004662333992323938,66
قصفها,2019-03-17,14190,14156,0.0023960535586754015,34
قصفها,2019-03-18,14159,14190,0.0021894201566361026,31
قصفها,2019-03-19,14286,14159,0.008889822202933653,127
قصفها,2019-03-25,14976,14286,0.04607371794564145,690
قصفها,2019-03-26,15722,14976,0.04744943391124224,746
قصفها,2019-03-27,16206,15722,0.029865481918433575,484
قصفها,2019-03-30,15627,16206,0.037051257436676824,579
قصفها,2019-03-31,16047,15627,0.026173116468737264,420
قصفها,2019-04-06,16812,16047,0.045503211988728094,765
قصفها,2019-04-07,17651,16812,0.04753271769035563,839
قصفها,2019-04-08,18425,17651,0.04200814111033877,774
قصفها,2019-04-09,19344,18425,0.04750827129613791,919
قصفها,2019-04-10,20306,19344,0.04737516004888333,962
قصفها,2019-04-13,21208,20306,0.04253112032994478,902
قصفها,2019-04-15,19970,21208,0.06199298948112203,1238
قصفها,2019-04-16,19042,19970,0.04873437663854981,928
قصفها,2019-04-17,18146,19042,0.04937727322553856,896
قصفها,2019-04-20,18740,18146,0.031696905014317135,594
قصفها,2019-04-22,19318,18740,0.029920281601101547,578
قصفها,2019-04-23,18593,19318,0.03899316947028488,725
قصفها,2019-04-24,18932,18593,0.017906190575855366,339
قصفها,2019-04-27,18835,18932,0.005149986726564906,97
قصفها,2019-04-28,19583,18835,0.038196394830301975,748
قصفها,2019-04-29,20562,19583,0.04761209998795778,979
قصفها,2019-04-30,20814,20562,0.012107235513975823,252
قصفها,2019-05-01,21420,20814,0.028291316525289854,606
قصفها,2019-05-04,22476,21420,0.04698344901018938,1056
قصفها,2019-05-05,22263,22476,0.009567443740306004,213
قصفها,2019-05-06,21182,22263,0.05103389670234001,1081
قصفها,2019-05-07,20138,21182,0.05184228820876739,1044
قصفها,2019-05-08,20406,20138,0.01313339213892319,268
قصفها,2019-05-11,21400,20406,0.04644859812867062,994
قصفها,2019-05-12,20649,21400,0.03636979998855296,751
قصفها,2019-05-13,21653,20649,0.04636770886037188,1004
قصفها,2019-05-14,22564,21653,0.04037404715297048,911
قصفها,2019-05-15,23174,22564,0.026322602915926356,610
قصفها,2019-05-18,23375,23174,0.008598930480915553,201
قصفها,2019-05-19,22348,23375,0.04595489529058731,1027
قصفها,2019-05-20,21249,22348,0.05172008094255164,1099
قصفها,2019-05-21,22155,21249,0.040893703451099356,906
قصفها,2019-05-22,22613,22155,0.02025383628796472,458
قصفها,2019-05-25,23173,22613,0.02416605532196237,560
قصفها,2019-05-26,22890,23173,0.012363477500552054,283
قصفها,2019-05-28,22949,22890,0.002570918122681994,59
قصفها,2019-05-29,22475,22949,0.021090100110296325,474
قصفها,2019-06-01,22850,22475,0.016411378555080465,375
قصفها,2019-06-02,23201,22850,0.015128658246837262,351
قصفها,2019-06-03,23765,23201,0.02373237954875942,564
قصفها,2019-06-08,24889,23765,0.04516051267446822,1124
قصفها,2019-06-09,26109,24889,0.046727182195919904,1220
قصفها,2019-06-10,25993,26109,0.004462739968281355,116
قصفها,2019-06-11,24795,25993,0.048316192778853954,1198
قصفها,2019-06-18,23315,24795,0.06347844734876781,1480
قصفها,2019-06-19,23320,23315,2.1440823326696363e-4,5
قصفها,2019-06-22,22156,23320,0.05253655894328685,1164
قصفها,2019-06-23,22360,22156,0.009123434704422029,204
قصفها,2019-06-24,22495,22360,0.006001333629428703,135
قصفها,2019-06-25,21971,22495,0.023849619952489663,524
قصفها,2019-06-26,21532,21971,0.020388259333996458,439
قصفها,2019-06-30,21649,21532,0.005404406669804406,117
قصفها,2019-07-01,22687,21649,0.045753074445905005,1038
قصفها,2019-07-02,23819,22687,0.04752508501416831,1132
قصفها,2019-07-03,25008,23819,0.047544785666684866,1189
قصفها,2019-07-06,25237,25008,0.0090739786817342,229
قصفها,2019-07-07,25375,25237,0.0054384236451058745,138
قصفها,2019-07-08,26410,25375,0.039189700869398346,1035
قصفها,2019-07-09,27553,26410,0.04148368598550126,1143
قصفها,2019-07-10,26388,27553,0.04414885553872409,1165
قصفها,2019-07-13,25096,26388,0.051482307935468506,1292
قصفها,2019-07-14,24079,25096,0.042235973252949206,1017
قصفها,2019-07-15,24138,24079,0.0024442787305309355,59
قصفها,2019-07-16,22971,24138,0.05080318662440454,1167
قصفها,2019-07-17,22186,22971,0.03538267375663109,785
قصفها,2019-07-20,23169,22186,0.042427381412990316,983
قصفها,2019-07-21,24327,23169,0.04760143050735391,1158
قصفها,2019-07-22,23503,24327,0.035059354123513624,824
قصفها,2019-07-23,22911,23503,0.025839116580426907,592
قصفها,2019-07-24,22665,22911,0.010853739245053883,246
قصفها,2019-07-27,23684,22665,0.04302482688553349,1019
قصفها,2019-07-28,23514,23684,0.007229735476429798,170
قصفها,2019-07-29,23058,23514,0.0197762164966703,456
قصفها,2019-07-30,22984,23058,0.0032196310475452647,74
قصفها,2019-07-31,23346,22984,0.015505868242289647,362
قصفها,2019-08-03,23339,23346,2.999271605338735e-4,7
قصفها,2019-08-04,24312,23339,0.04002138861302972,973
قصفها,2019-08-05,25509,24312,0.046924614839981005,1197
قصفها,2019-08-06,26056,25509,0.020993245316971398,547
قصفها,2019-08-07,25069,26056,0.03937133511351185,987
قصفها,2019-08-10,24456,25069,0.02506542361690115,613
قصفها,2019-08-11,24244,24456,0.008744431611584539,212
قصفها,2019-08-13,24013,24244,0.009619789280405622,231
قصفها,2019-08-14,23296,24013,0.03077781593274477,717
قصفها,2019-08-17,23320,23296,0.0010291595196814255,24
قصفها,2019-08-18,24040,23320,0.029950083193429698,720
قصفها,2019-08-19,25196,24040,0.04588029845825209,1156
قصفها,2019-08-21,25995,25196,0.030736680129611976,799
قصفها,2019-08-24,26635,25995,0.024028533883085092,640
قصفها,2019-08-25,25699,26635,0.03642165064646789,936
قصفها,2019-08-26,26760,25699,0.039648729445454084,1061
قصفها,2019-08-27,28095,26760,0.047517351840273454,1335
قصفها,2019-08-28,29177,28095,0.037084004522840455,1082
قصفها,2019-08-31,34103,29177,0.14444477025058075,4926
قصفها,2019-09-01,32495,34103,0.049484536080951394,1608
قصفها,2019-09-02,31010,32495,0.047887778134540863,1485
قصفها,2019-09-03,29517,31010,0.050581021104767386,1493
قصفها,2019-09-04,29764,29517,0.008298615777170453,247
قصفها,2019-09-07,30212,29764,0.01482854494853606,448
قصفها,2019-09-08,31079,30212,0.027896650470481784,867
قصفها,2019-09-11,30643,31079,0.01422837189523779,436
قصفها,2019-09-14,29780,30643,0.02897918065718673,863
قصفها,2019-09-15,28934,29780,0.02923895762669389,846
قصفها,2019-09-16,30307,28934,0.0453030652969511,1373
قصفها,2019-09-17,31386,30307,0.0343783852662213,1079
قصفها,2019-09-18,30167,31386,0.04040839327608286,1219
قصفها,2019-09-21,31617,30167,0.04586140367378747,1450
قصفها,2019-09-22,33197,31617,0.047594662166834514,1580
قصفها,2019-09-23,34856,33197,0.04759582281249725,1659
قصفها,2019-09-24,36502,34856,0.04509341953742005,1646
قصفها,2019-09-25,38274,36502,0.04629774781715269,1772
قصفها,2019-09-28,39197,38274,0.023547720488212166,923
قصفها,2019-09-29,37476,39197,0.045922723875388975,1721
قصفها,2019-09-30,38038,37476,0.014774698984836881,562
قصفها,2019-10-01,37995,38038,0.0011317278588990202,43
قصفها,2019-10-02,37680,37995,0.008359872611243104,315
قصفها,2019-10-05,36690,37680,0.02698282910801355,990
قصفها,2019-10-06,34980,36690,0.048885077185566464,1710
قصفها,2019-10-07,34773,34980,0.005952894486930869,207
قصفها,2019-10-08,33109,34773,0.05025823793982729,1664
قصفها,2019-10-09,33213,33109,0.0031313040073726764,104
قصفها,2019-10-12,33901,33213,0.02029438659566696,688
قصفها,2019-10-13,33346,33901,0.016643675402847606,555
قصفها,2019-10-14,32213,33346,0.03517213547216428,1133
قصفها,2019-10-15,30848,32213,0.04424922199026682,1365
قصفها,2019-10-16,29449,30848,0.04750585758268512,1399
قصفها,2019-10-20,27996,29449,0.05190027146549863,1453
قصفها,2019-10-21,27424,27996,0.02085764293972952,572
قصفها,2019-10-22,28740,27424,0.045789839942735215,1316
قصفها,2019-10-23,29044,28740,0.010466877840157455,304
قصفها,2019-10-26,30035,29044,0.03299483935298835,991
قصفها,2019-10-28,31525,30035,0.04726407612855625,1490
قصفها,2019-10-30,32914,31525,0.04220088715919667,1389
قصفها,2019-11-02,32174,32914,0.02299993783729098,740
قصفها,2019-11-03,32726,32174,0.016867322617586403,552
قصفها,2019-11-04,32198,32726,0.016398534069929856,528
قصفها,2019-11-05,31609,32198,0.018633933372816793,589
قصفها,2019-11-09,32952,31609,0.04075625151612174,1343
قصفها,2019-11-10,32840,32952,0.0034104750303468184,112
قصفها,2019-11-11,32436,32840,0.012455296583658427,404
قصفها,2019-11-12,32131,32436,0.0094923905259876,305
قصفها,2019-11-13,31446,32131,0.02178337467335167,685
قصفها,2019-11-16,32706,31446,0.03852504127565202,1260
قصفها,2019-11-17,31073,32706,0.052553663950936386,1633
قصفها,2019-11-18,29676,31073,0.047075077502120394,1397
قصفها,2019-11-19,31136,29676,0.046891058580200054,1460
قصفها,2019-11-20,32581,31136,0.044351002116437464,1445
قصفها,2019-11-23,34110,32581,0.044825564349316165,1529
قصفها,2019-11-24,35118,34110,0.028703229112457908,1008
قصفها,2019-11-25,35105,35118,3.70317618562304e-4,13
قصفها,2019-11-26,34560,35105,0.01576967592546963,545
قصفها,2019-11-27,34305,34560,0.00743331875798183,255
قصفها,2019-11-30,34983,34305,0.01938084212276303,678
قصفها,2019-12-01,36558,34983,0.043082225503499036,1575
قصفها,2019-12-02,38300,36558,0.045483028719439086,1742
قصفها,2019-12-03,40117,38300,0.045292519379682115,1817
قصفها,2019-12-04,41531,40117,0.034046856564155764,1414
قصفها,2019-12-07,39725,41531,0.045462555064934865,1806
قصفها,2019-12-08,40859,39725,0.027753983209874104,1134
قصفها,2019-12-09,39708,40859,0.028986602195301032,1151
قصفها,2019-12-10,39826,39708,0.0029628885651844803,118
قصفها,2019-12-11,39361,39826,0.011813724244510715,465
قصفها,2019-12-14,39948,39361,0.014694102332665111,587
قصفها,2019-12-15,39309,39948,0.016255819277614394,639
قصفها,2019-12-16,39082,39309,0.0058083004962435824,227
قصفها,2019-12-17,38728,39082,0.009140673414347742,354
قصفها,2019-12-18,40209,38728,0.036832549925717314,1481
قصفها,2019-12-21,42219,40209,0.047608896467287026,2010
قصفها,2019-12-22,44127,42219,0.043238833366346256,1908
قصفها,2019-12-23,42180,44127,0.04615931721085445,1947
قصفها,2019-12-24,44205,42180,0.04580929758973398,2025
قصفها,2019-12-25,45193,44205,0.02186179275503149,988
قصفها,2019-12-28,45169,45193,5.313378644528031e-4,24
قصفها,2019-12-29,43112,45169,0.047712933752836494,2057
قصفها,2019-12-30,43057,43112,0.0012773765008877215,55
قصفها,2019-12-31,43092,43057,8.122157244775778e-4,35
قصفها,2020-01-01,43849,43092,0.017263791648218573,757
قصفها,2020-01-04,43411,43849,0.010089608624309746,438
قصفها,2020-01-05,41243,43411,0.052566496131402504,2168
قصفها,2020-01-07,40189,41243,0.026226081763014105,1054
قصفها,2020-01-08,39386,40189,0.020387955110435486,803
قصفها,2020-01-11,40173,39386,0.019590272072795404,787
قصفها,2020-01-12,42181,40173,0.04760437163539024,2008
قصفها,2020-01-13,44211,42181,0.04591617470661337,2030
قصفها,2020-01-14,46248,44211,0.04404514789733512,2037
قصفها,2020-01-15,48438,46248,0.04521243651585093,2190
قصفها,2020-01-18,50859,48438,0.0476021943009575,2421
قصفها,2020-01-19,52733,50859,0.03553751919982672,1874
قصفها,2020-01-20,55275,52733,0.0459882406142743,2542
قصفها,2020-01-21,56259,55275,0.0174905348474468,984
قصفها,2020-01-22,56434,56259,0.003100967501805632,175
قصفها,2020-01-25,54027,56434,0.04455179817416196,2407
قصفها,2020-01-26,54152,54027,0.0023083173289572254,125
قصفها,2020-01-27,53968,54152,0.0034094278090088677,184
قصفها,2020-01-28,54684,53968,0.013093409406534024,716
قصفها,2020-02-01,57418,54684,0.047615730257974574,2734
قصفها,2020-02-02,60288,57418,0.04760483014783033,2870
قصفها,2020-02-04,59235,60288,0.017776652316742185,1053
قصفها,2020-02-05,56377,59235,0.05069443212567724,2858
قصفها,2020-02-08,53835,56377,0.047218352372114455,2542
قصفها,2020-02-09,54670,53835,0.01527345893515139,835
قصفها,2020-02-10,56667,54670,0.035240969170147685,1997
قصفها,2020-02-12,54466,56667,0.040410531339910946,2201
قصفها,2020-02-15,53101,54466,0.02570573058839371,1365
قصفها,2020-02-16,52785,53101,0.005986549208942189,316
قصفها,2020-02-17,53334,52785,0.010293621329540375,549
قصفها,2020-02-18,53720,53334,0.007185405807759021,386
قصفها,2020-02-19,54451,53720,0.013424914142744396,731
قصفها,2020-02-22,53590,54451,0.016066430303861422,861
قصفها,2020-02-23,56065,53590,0.044145188619563985,2475
قصفها,2020-02-24,57097,56065,0.01807450478977749,1032
قصفها,2020-02-25,59765,57097,0.04464151259023439,2668
قصفها,2020-02-26,58714,59765,0.017900330414928292,1051
قصفها,2020-02-29,55834,58714,0.05158147365312209,2880
قصفها,2020-03-01,57905,55834,0.035765477937384244,2071
قصفها,2020-03-02,59578,57905,0.02808083520715565,1673
قصفها,2020-03-03,61300,59578,0.028091353996279097,1722
قصفها,2020-03-04,62390,61300,0.01747074851711058,1090
قصفها,2020-03-07,65163,62390,0.042554824055943484,2773
قصفها,2020-03-09,63461,65163,0.026819621499396172,1702
قصفها,2020-03-10,62173,63461,0.02071638814242973,1288
قصفها,2020-03-11,61192,62173,0.016031507386324494,981
قصفها,2020-03-14,61077,61192,0.0018828691651213572,115
قصفها,2020-03-15,60440,61077,0.01053937789525911,637
قصفها,2020-03-16,60095,60440,0.005740910225380798,345
قصفها,2020-03-17,59585,60095,0.008559201141083172,510
قصفها,2020-03-18,60792,59585,0.019854586129427317,1207
قصفها,2020-03-24,61610,60792,0.013277065411243677,818
قصفها,2020-03-25,63828,61610,0.03474963965603262,2218
قصفها,2020-03-28,65086,63828,0.019328273361101798,1258
قصفها,2020-03-29,68339,65086,0.04760093065383455,3253
قصفها,2020-03-30,69608,68339,0.018230663141905665,1269
قصفها,2020-04-04,73088,69608,0.047613835375880945,3480
قصفها,2020-04-05,76719,73088,0.047328562676164594,3631
قصفها,2020-04-06,79918,76719,0.04002852924197267,3199
قصفها,2020-04-07,81781,79918,0.022780352404314204,1863
قصفها,2020-04-08,84800,81781,0.0356014150939198,3019
قصفها,2020-04-11,87701,84800,0.03307830013303066,2901
قصفها,2020-04-12,90982,87701,0.036062078212876596,3281
قصفها,2020-04-15,99785,90982,0.08821967229455109,8803
قصفها,2020-04-18,104774,99785,0.04761677515368683,4989
قصفها,2020-04-19,108249,104774,0.032101913181349466,3475
قصفها,2020-04-20,108774,108249,0.004826521043587379,525
قصفها,2020-04-21,107010,108774,0.016484440706321987,1764
قصفها,2020-04-22,111903,107010,0.043725369292657704,4893
قصفها,2020-04-25,117498,111903,0.04761783179247632,5595
قصفها,2020-04-26,118728,117498,0.01035981402861701,1230
قصفها,2020-04-27,122495,118728,0.03075227560283479,3767
قصفها,2020-04-28,128607,122495,0.047524629296636076,6112
قصفها,2020-04-29,135037,128607,0.047616579159433216,6430
قصفها,2020-05-02,141788,135037,0.04761333822292709,6751
قصفها,2020-05-03,148877,141788,0.04761648877900806,7089
قصفها,2020-05-04,144962,148877,0.02700707771673261,3915
قصفها,2020-05-05,142086,144962,0.020241262333936902,2876
قصفها,2020-05-06,139719,142086,0.016941146157523734,2367
قصفها,2020-05-09,145676,139719,0.040892116751964,5957
قصفها,2020-05-10,139182,145676,0.04665833225527253,6494
قصفها,2020-05-11,132512,139182,0.050335063993824446,6670
قصفها,2020-05-12,126902,132512,0.04420734109750668,5610
قصفها,2020-05-13,132781,126902,0.0442759129691426,5879
قصفها,2020-05-16,128250,132781,0.03532943469758028,4531
قصفها,2020-05-17,125840,128250,0.019151303242060148,2410
قصفها,2020-05-18,130890,125840,0.038582015432511406,5050
قصفها,2020-05-19,133342,130890,0.018388804727554792,2452
قصفها,2020-05-20,140009,133342,0.04761836739032763,6667
قصفها,2020-05-23,143246,140009,0.022597489633060627,3237
قصفها,2020-05-26,150129,143246,0.0458472380416452,6883
قصفها,2020-05-27,153512,150129,0.022037365156977712,3383
قصفها,2020-05-30,160343,153512,0.04260242105958724,6831
قصفها,2020-05-31,167899,160343,0.045003245998814743,7556
قصفها,2020-06-01,176023,167899,0.04615305954309293,8124
قصفها,2020-06-02,183852,176023,0.04258316471921663,7829
قصفها,2020-06-06,177953,183852,0.033149202317279566,5899
قصفها,2020-06-07,189942,177953,0.06311926798673742,11989
قصفها,2020-06-08,180891,189942,0.05003565683173825,9051
قصفها,2020-06-09,172111,180891,0.051013590066579045,8780
قصفها,2020-06-10,180340,172111,0.045630475767740764,8229
قصفها,2020-06-13,179750,180340,0.0032823365785631022,590
قصفها,2020-06-14,173030,179750,0.038837195861764796,6720
قصفها,2020-06-15,176570,173030,0.020048705895565223,3540
قصفها,2020-06-16,174170,176570,0.013779640580962394,2400
قصفها,2020-06-20,177240,174170,0.01732114646796817,3070
قصفها,2020-06-21,173840,177240,0.01955821444995652,3400
قصفها,2020-06-22,177100,173840,0.018407679277140553,3260
قصفها,2020-06-23,185940,177100,0.047542217919503374,8840
قصفها,2020-06-24,191670,185940,0.029895132258413445,5730
قصفها,2020-06-27,189980,191670,0.008895673228714098,1690
قصفها,2020-06-28,181080,189980,0.04914954716120416,8900
قصفها,2020-06-29,177400,181080,0.02074408117237461,3680
قصفها,2020-06-30,172110,177400,0.030736157108647164,5290
قصفها,2020-07-01,174300,172110,0.012564543889773008,2190
قصفها,2020-07-04,169500,174300,0.02831858407062939,4800
قصفها,2020-07-05,169750,169500,0.0014727540500649617,250
قصفها,2020-07-06,178230,169750,0.04757897099227078,8480
قصفها,2020-07-07,185060,178230,0.036906949097390535,6830
قصفها,2020-07-08,176260,185060,0.04992624531913124,8800
قصفها,2020-07-11,167450,176260,0.05261272021467535,8810
قصفها,2020-07-12,175050,167450,0.043416166809234984,7600
قصفها,2020-07-13,176380,175050,0.007540537475861545,1330
قصفها,2020-07-14,171040,176380,0.0312207670718474,5340
قصفها,2020-07-15,178810,171040,0.04345394552853054,7770
قصفها,2020-07-18,187750,178810,0.047616511317988726,8940
قصفها,2020-07-19,197130,187750,0.047582813371645195,9380
قصفها,2020-07-20,205680,197130,0.04156942823783757,8550
قصفها,2020-07-21,215960,205680,0.04760140766786626,10280
قصفها,2020-07-22,226750,215960,0.047585446526802265,10790
قصفها,2020-07-25,238080,226750,0.047589045698724845,11330
قصفها,2020-07-26,249980,238080,0.047603808304473944,11900
قصفها,2020-07-27,262470,249980,0.047586390825436864,12490
قصفها,2020-07-28,265630,262470,0.011896246658841635,3160
قصفها,2020-08-01,278910,265630,0.04761392563892433,13280
قصفها,2020-08-02,284410,278910,0.0193382792446843,5500
قصفها,2020-08-03,272940,284410,0.04202388803384618,11470
قصفها,2020-08-04,274820,272940,0.006840841277902478,1880
قصفها,2020-08-05,288530,274820,0.04751672269764837,13710
قصفها,2020-08-09,301800,288530,0.04396951623577213,13270
قصفها,2020-08-10,290120,301800,0.04025920308823845,11680
قصفها,2020-08-11,275890,290120,0.05157852767388604,14230
قصفها,2020-08-12,272390,275890,0.012849223539730352,3500
قصفها,2020-08-15,258940,272390,0.05194253494998091,13450
قصفها,2020-08-16,246280,258940,0.05140490498598585,12660
قصفها,2020-08-17,238190,246280,0.033964482135967235,8090
قصفها,2020-08-18,248220,238190,0.040407702844088275,10030
قصفها,2020-08-19,243580,248220,0.019049183019874173,4640
قصفها,2020-08-22,236020,243580,0.03203118379784751,7560
قصفها,2020-08-23,226770,236020,0.0407902279841214,9250
قصفها,2020-08-24,218280,226770,0.03889499725105875,8490
قصفها,2020-08-25,221830,218280,0.016003245728639034,3550
قصفها,2020-08-26,232920,221830,0.04761291430513647,11090
قصفها,2020-08-31,231920,232920,0.004311831666073164,1000
قصفها,2020-09-01,227980,231920,0.017282217738322298,3940
قصفها,2020-09-02,225760,227980,0.009833451452826747,2220
قصفها,2020-09-05,214540,225760,0.05229793977788618,11220
قصفها,2020-09-06,209170,214540,0.02567289764294271,5370
قصفها,2020-09-07,208270,209170,0.004321313679337776,900
قصفها,2020-09-08,208110,208270,7.688241795167516e-4,160
قصفها,2020-09-09,202160,208110,0.02943213296384333,5950
پكوير,2018-01-15,3276,3281,0.0015262515257856376,5
پكوير,2018-01-16,3280,3276,0.0012195121947501488,4
پكوير,2018-01-17,3283,3280,9.137983548846183e-4,3
پكوير,2018-01-20,3318,3283,0.010548523203571874,35
پكوير,2018-01-21,3311,3318,0.002114164904224052,7
پكوير,2018-01-22,3199,3311,0.03501094090809286,112
پكوير,2018-01-23,3213,3199,0.004357298473589387,14
پكوير,2018-01-24,3216,3213,9.328358206054615e-4,3
پكوير,2018-01-27,3225,3216,0.002790697673553272,9
پكوير,2018-01-28,3252,3225,0.008302583023277188,27
پكوير,2018-01-29,3267,3252,0.004591368226326486,15
پكوير,2018-01-30,3267,3267,0,0
پكوير,2018-01-31,3270,3267,9.174311923799905e-4,3
پكوير,2018-02-03,3298,3270,0.008489993933144332,28
پكوير,2018-02-04,3313,3298,0.004527618471316747,15
پكوير,2018-02-05,3327,3313,0.004207995189597837,14
پكوير,2018-02-06,3315,3327,0.0036199095011704647,12
پكوير,2018-02-07,3317,3315,6.029544767552142e-4,2
پكوير,2018-02-10,3317,3317,0,0
پكوير,2018-02-12,3332,3317,0.004501800718937035,15
پكوير,2018-02-13,3334,3332,5.99880023815273e-4,2
پكوير,2018-02-14,3335,3334,2.998500748726087e-4,1
پكوير,2018-02-17,3335,3335,0,0
پكوير,2018-02-18,3332,3335,9.003601437874069e-4,3
پكوير,2018-02-19,3332,3332,0,0
پكوير,2018-02-21,3318,3332,0.00421940928142875,14
پكوير,2018-02-24,3315,3318,9.049773752926162e-4,3
پكوير,2018-02-25,3257,3315,0.017807798582189806,58
پكوير,2018-02-26,3256,3257,3.071253070309812e-4,1
پكوير,2018-02-27,3251,3256,0.0015379883108157526,5
پكوير,2018-02-28,3254,3251,9.219422246705771e-4,3
پكوير,2018-03-03,3320,3254,0.019879518066301352,66
پكوير,2018-03-04,3322,3320,6.020469594816235e-4,2
پكوير,2018-03-10,2945,3322,0.12801358229948606,377
پكوير,2018-03-11,2942,2945,0.0010197144795990095,3
پكوير,2018-03-12,2929,2942,0.004438374870454635,13
پكوير,2018-03-13,2902,2929,0.009303928322086862,27
پكوير,2018-03-14,2901,2902,3.447087210118205e-4,1
پكوير,2018-03-17,2878,2901,0.007991660872831251,23
پكوير,2018-03-18,2877,2878,3.475842890693138e-4,1
پكوير,2018-03-19,2945,2877,0.023089983014230906,68
پكوير,2018-03-25,2946,2945,3.394433128515128e-4,1
پكوير,2018-03-26,2946,2946,0,0
پكوير,2018-03-27,2958,2946,0.004056795130474376,12
پكوير,2018-03-28,2958,2958,0,0
پكوير,2018-04-04,2958,2958,0,0
پكوير,2018-04-07,2955,2958,0.0010152284260523763,3
پكوير,2018-04-08,2938,2955,0.005786249147111556,17
پكوير,2018-04-09,2896,2938,0.014502762425931367,42
پكوير,2018-04-10,2877,2896,0.006604101492316962,19
پكوير,2018-04-11,2837,2877,0.014099400770497216,40
پكوير,2018-04-15,2819,2837,0.006385242991704419,18
پكوير,2018-04-16,2815,2819,0.0014209591469197304,4
پكوير,2018-04-17,2774,2815,0.014780100931946611,41
پكوير,2018-04-18,2756,2774,0.006531204642042379,18
پكوير,2018-04-21,2621,2756,0.05150705835501448,135
پكوير,2018-04-22,2590,2621,0.011969111964490691,31
پكوير,2018-04-23,2579,2590,0.004265219075507864,11
پكوير,2018-04-24,2668,2579,0.03335832082707709,89
پكوير,2018-04-25,2746,2668,0.028404952648068117,78
پكوير,2018-04-28,2726,2746,0.007336757150646824,20
پكوير,2018-04-29,2709,2726,0.006275378366085132,17
پكوير,2018-04-30,2646,2709,0.023809523800525503,63
پكوير,2018-05-01,2642,2646,0.0015140045414405736,4
پكوير,2018-05-05,2612,2642,0.011485451756705418,30
پكوير,2018-05-06,2612,2612,0,0
پكوير,2018-05-07,2587,2612,0.009663703127304328,25
پكوير,2018-05-08,2584,2587,0.0011609907116250037,3
پكوير,2018-05-09,2518,2584,0.026211278782283052,66
پكوير,2018-05-12,2517,2518,3.972983709188326e-4,1
پكوير,2018-05-13,2482,2517,0.014101531017686733,35
پكوير,2018-05-14,2592,2482,0.04243827158856548,110
پكوير,2018-05-15,2712,2592,0.044247787594303915,120
پكوير,2018-05-16,2753,2712,0.01489284416458669,41
پكوير,2018-05-19,2751,2753,7.270083603318763e-4,2
پكوير,2018-05-20,2742,2751,0.0032822757099627005,9
پكوير,2018-05-21,2702,2742,0.014803848995261345,40
پكوير,2018-05-23,2688,2702,0.005208333331395709,14
پكوير,2018-05-27,2745,2688,0.020765027314839698,57
پكوير,2018-05-28,2730,2745,0.005494505492492856,15
پكوير,2018-05-29,2601,2730,0.04959630909281188,129
پكوير,2018-05-30,2577,2601,0.009313154827585117,24
پكوير,2018-06-02,2653,2577,0.02864681491570041,76
پكوير,2018-06-03,2581,2653,0.02789616426660358,72
پكوير,2018-06-09,2563,2581,0.007023019895816223,18
پكوير,2018-06-10,2601,2563,0.014609765469200398,38
پكوير,2018-06-11,2586,2601,0.005800464034879944,15
پكوير,2018-06-12,2595,2586,0.003468208091149053,9
پكوير,2018-06-13,2703,2595,0.039955604868680876,108
پكوير,2018-06-17,2772,2703,0.024891774882795176,69
پكوير,2018-06-18,2788,2772,0.005738880916162525,16
پكوير,2018-06-19,2752,2788,0.013081395344083795,36
پكوير,2018-06-20,2701,2752,0.018881895587233657,51
پكوير,2018-06-23,2711,2701,0.0036886757640395887,10
پكوير,2018-06-24,2821,2711,0.03899326478589392,110
پكوير,2018-06-25,2940,2821,0.04047619046242307,119
پكوير,2018-06-26,3087,2940,0.04761904760362195,147
پكوير,2018-06-27,3241,3087,0.04751619868944271,154
پكوير,2018-06-30,3403,3241,0.04760505434980751,162
پكوير,2018-07-01,3334,3403,0.020695860821626916,69
پكوير,2018-07-02,3171,3334,0.05140334277786082,163
پكوير,2018-07-03,3192,3171,0.006578947366359979,21
پكوير,2018-07-04,3135,3192,0.01818181817601856,57
پكوير,2018-07-07,3116,3135,0.0060975609736529015,19
پكوير,2018-07-08,3163,3116,0.014859310776206352,47
پكوير,2018-07-10,3146,3163,0.005403687220151403,17
پكوير,2018-07-11,3029,3146,0.038626609429307825,117
پكوير,2018-07-14,3062,3029,0.010777269754808208,33
پكوير,2018-07-15,3035,3062,0.008896210870215417,27
پكوير,2018-07-16,2959,3035,0.02568435281321921,76
پكوير,2018-07-17,2921,2959,0.013009243405337472,38
پكوير,2018-07-18,2962,2921,0.013841998644887915,41
پكوير,2018-07-21,2945,2962,0.0057724957535577265,17
پكوير,2018-07-22,3073,2945,0.04165310769877868,128
پكوير,2018-07-23,3071,3073,6.512536630897904e-4,2
پكوير,2018-07-24,3049,3071,0.007215480483038544,22
پكوير,2018-07-25,3016,3049,0.010941644558706352,33
پكوير,2018-07-28,2959,3016,0.01926326460991441,57
پكوير,2018-07-29,2901,2959,0.01999310581868559,58
پكوير,2018-07-30,2795,2901,0.03792486581827375,106
پكوير,2018-07-31,2920,2795,0.04280821916342185,125
پكوير,2018-08-01,2924,2920,0.0013679890556197029,4
پكوير,2018-08-04,2877,2924,0.016336461586257747,47
پكوير,2018-08-05,2814,2877,0.02238805969353658,63
پكوير,2018-08-06,2695,2814,0.0441558441394598,119
پكوير,2018-08-07,2669,2695,0.009741476204667863,26
پكوير,2018-08-08,2682,2669,0.004847129006395552,13
پكوير,2018-08-11,2690,2682,0.0029739776940617183,8
پكوير,2018-08-12,2701,2690,0.0040725657148935335,11
پكوير,2018-08-13,2711,2701,0.0036886757640395887,10
پكوير,2018-08-14,2698,2711,0.004818383986353453,13
پكوير,2018-08-15,2727,2698,0.010634396769110967,29
پكوير,2018-08-18,2852,2727,0.04382889199024233,125
پكوير,2018-08-19,2860,2852,0.0027972027962247545,8
پكوير,2018-08-20,2840,2860,0.007042253518647094,20
پكوير,2018-08-21,2891,2840,0.017640954680857506,51
پكوير,2018-08-25,3013,2891,0.04049120476585091,122
پكوير,2018-08-26,3162,3013,0.04712207462140352,149
پكوير,2018-08-27,3278,3162,0.03538743134979029,116
پكوير,2018-08-28,3184,3278,0.029522613056054456,94
پكوير,2018-08-29,3157,3184,0.008552423183860493,27
پكوير,2018-09-01,3303,3157,0.04420224037414404,146
پكوير,2018-09-02,3275,3303,0.008549618318000118,28
پكوير,2018-09-03,3234,3275,0.012677798388163946,41
پكوير,2018-09-04,3362,3234,0.03807257583638531,128
پكوير,2018-09-05,3311,3362,0.015403201445060948,51
پكوير,2018-09-08,3406,3311,0.02789195536468234,95
پكوير,2018-09-09,3572,3406,0.04647256437668741,166
پكوير,2018-09-10,3749,3572,0.04721259001141302,177
پكوير,2018-09-11,3842,3749,0.024206142627744367,93
پكوير,2018-09-12,4031,3842,0.04688662861650047,189
پكوير,2018-09-15,4243,4031,0.049964647643185325,212
پكوير,2018-09-16,4058,4243,0.04558896006762224,185
پكوير,2018-09-17,4259,4058,0.04719417702578206,201
پكوير,2018-09-18,4462,4259,0.045495293580122075,203
پكوير,2018-09-22,4675,4462,0.04556149731645743,213
پكوير,2018-09-23,4741,4675,0.013921113686158802,66
پكوير,2018-09-24,4674,4741,0.014334617027313945,67
پكوير,2018-09-25,4695,4674,0.00447284344952655,21
پكوير,2018-09-26,4637,4695,0.012508087122599074,58
پكوير,2018-09-29,4823,4637,0.03856520836853303,186
پكوير,2018-09-30,5030,4823,0.04115308150275286,207
پكوير,2018-10-01,4895,5030,0.027579162404988932,135
پكوير,2018-10-02,4711,4895,0.03905752493333527,184
پكوير,2018-10-03,4476,4711,0.05250223412589315,235
پكوير,2018-10-06,4265,4476,0.0494724501642503,211
پكوير,2018-10-07,4234,4265,0.007321681623211695,31
پكوير,2018-10-08,4141,4234,0.02245834338989173,93
پكوير,2018-10-09,3978,4141,0.04097536449447578,163
پكوير,2018-10-10,3807,3978,0.044917257671416536,171
پكوير,2018-10-13,3629,3807,0.04904932486937191,178
پكوير,2018-10-14,3586,3629,0.011991076404910464,43
پكوير,2018-10-15,3690,3586,0.028184281835180413,104
پكوير,2018-10-16,3868,3690,0.04601861425904379,178
پكوير,2018-10-17,4021,3868,0.03805023625017403,153
پكوير,2018-10-20,4182,4021,0.03849832615052646,161
پكوير,2018-10-21,3990,4182,0.048120300739819474,192
پكوير,2018-10-22,3896,3990,0.0241273100554088,94
پكوير,2018-10-23,3711,3896,0.049851791956385935,185
پكوير,2018-10-24,3582,3711,0.036013400324954384,129
پكوير,2018-10-27,3468,3582,0.03287197230886045,114
پكوير,2018-10-28,3388,3468,0.023612750878508636,80
پكوير,2018-10-29,3495,3388,0.030615164511984216,107
پكوير,2018-10-31,3653,3495,0.04325212153209633,158
پكوير,2018-11-03,3618,3653,0.009673852954761235,35
پكوير,2018-11-04,3562,3618,0.01572150476818599,56
پكوير,2018-11-05,3591,3562,0.008075744915601297,29
پكوير,2018-11-06,3746,3591,0.04137746928954152,155
پكوير,2018-11-10,3803,3746,0.01498816723245118,57
پكوير,2018-11-11,3630,3803,0.047658402190727714,173
پكوير,2018-11-12,3794,3630,0.04322614653578647,164
پكوير,2018-11-13,3963,3794,0.04264446125595649,169
پكوير,2018-11-14,3976,3963,0.003269617705415086,13
پكوير,2018-11-17,3995,3976,0.004755944929973481,19
پكوير,2018-11-18,3891,3995,0.026728347461647817,104
پكوير,2018-11-19,4079,3891,0.04608972786317977,188
پكوير,2018-11-20,4083,4079,9.796718097037297e-4,4
پكوير,2018-11-21,4246,4083,0.03838907205878731,163
پكوير,2018-11-24,4309,4246,0.01462056161183092,63
پكوير,2018-11-26,4141,4309,0.04056991063980441,168
پكوير,2018-11-27,4111,4141,0.00729749452510399,30
پكوير,2018-11-28,4011,4111,0.024931438537788224,100
پكوير,2018-12-01,3849,4011,0.042088854236921575,162
پكوير,2018-12-02,3966,3849,0.029500756422213628,117
پكوير,2018-12-03,3897,3966,0.017705927632100098,69
پكوير,2018-12-04,3837,3897,0.015637216571374193,60
پكوير,2018-12-05,3987,3837,0.037622272375815835,150
پكوير,2018-12-08,4093,3987,0.025897874413413666,106
پكوير,2018-12-09,4207,4093,0.027097694312551057,114
پكوير,2018-12-10,4245,4207,0.008951707889528454,38
پكوير,2018-12-11,4225,4245,0.004733727809530478,20
پكوير,2018-12-12,4189,4225,0.008593936498306531,36
پكوير,2018-12-15,4037,4189,0.03765172156610064,152
پكوير,2018-12-16,3975,4037,0.015597484272805665,62
پكوير,2018-12-18,3966,3975,0.0022692889555548943,9
پكوير,2018-12-19,3870,3966,0.024806201543977727,96
پكوير,2018-12-22,4068,3870,0.048672566359716674,198
پكوير,2018-12-23,4259,4068,0.04484620801952425,191
پكوير,2018-12-24,4443,4259,0.041413459364975584,184
پكوير,2018-12-25,4410,4443,0.007482993195582087,33
پكوير,2018-12-26,4405,4410,0.001135073779538008,5
پكوير,2018-12-29,4620,4405,0.046536796526723635,215
پكوير,2018-12-30,4582,4620,0.008293321691773608,38
پكوير,2018-12-31,4801,4582,0.04561549676200469,219
پكوير,2019-01-01,5022,4801,0.044006371954598486,221
پكوير,2019-01-02,5230,5022,0.039770554485703526,208
پكوير,2019-01-05,5324,5230,0.017655897817870792,94
پكوير,2019-01-06,5063,5324,0.051550464141506915,261
پكوير,2019-01-07,5067,5063,7.894217484133763e-4,4
پكوير,2019-01-08,5098,5067,0.006080816005084187,31
پكوير,2019-01-09,5020,5098,0.0155378486024825,78
پكوير,2019-01-12,5145,5020,0.02429543245397562,125
پكوير,2019-01-13,4992,5145,0.03064903845539883,153
پكوير,2019-01-14,4820,4992,0.03568464729550111,172
پكوير,2019-01-15,4652,4820,0.036113499562314376,168
پكوير,2019-01-16,4839,4652,0.038644347997800296,187
پكوير,2019-01-19,5068,4839,0.045185477497003655,229
پكوير,2019-01-20,5187,5068,0.022941970305968385,119
پكوير,2019-01-21,5249,5187,0.011811773668925172,62
پكوير,2019-01-22,5411,5249,0.02993901311588634,162
پكوير,2019-01-23,5508,5411,0.01761074799970756,97
پكوير,2019-01-26,5673,5508,0.029085140132366447,165
پكوير,2019-01-27,5491,5673,0.03314514659749678,182
پكوير,2019-01-28,5378,5491,0.021011528445330694,113
پكوير,2019-01-29,5249,5378,0.0245761097305056,129
پكوير,2019-01-30,5105,5249,0.028207639563524456,144
پكوير,2019-02-02,5063,5105,0.00829547698828847,42
پكوير,2019-02-03,5157,5063,0.018227651731970593,94
پكوير,2019-02-04,5211,5157,0.010362694298529516,54
پكوير,2019-02-05,5151,5211,0.011648223643632648,60
پكوير,2019-02-06,5104,5151,0.009208463948039093,47
پكوير,2019-02-10,5071,5104,0.006507592189606075,33
پكوير,2019-02-12,5052,5071,0.0037608867767694202,19
پكوير,2019-02-13,4979,5052,0.014661578627302354,73
پكوير,2019-02-16,4939,4979,0.008098805424559869,40
پكوير,2019-02-17,4988,4939,0.00982357658183168,49
پكوير,2019-02-18,5170,4988,0.03520309477075375,182
پكوير,2019-02-19,5009,5170,0.032142144134130135,161
پكوير,2019-02-20,4816,5009,0.04007475082224361,193
پكوير,2019-02-23,4622,4816,0.041973171778023975,194
پكوير,2019-02-24,4782,4622,0.03345880384076562,160
پكوير,2019-02-25,4833,4782,0.010552451891050599,51
پكوير,2019-02-26,4916,4833,0.01688364523659812,83
پكوير,2019-03-04,4832,4916,0.017384105956667194,84
پكوير,2019-03-05,5052,4832,0.04354711004680382,220
پكوير,2019-03-06,5098,5052,0.009023146330124921,46
پكوير,2019-03-09,4986,5098,0.0224628961046003,112
پكوير,2019-03-10,5016,4986,0.005980861242826782,30
پكوير,2019-03-11,4966,5016,0.010068465563820284,50
پكوير,2019-03-12,4827,4966,0.028796353837000962,139
پكوير,2019-03-13,4866,4827,0.008014796545825154,39
پكوير,2019-03-16,4954,4866,0.01776342349257904,88
پكوير,2019-03-17,4919,4954,0.007115267329311797,35
پكوير,2019-03-18,4909,4919,0.0020370747602287483,10
پكوير,2019-03-19,4974,4909,0.013067953354831532,65
پكوير,2019-03-25,5000,4974,0.00519999999896,26
پكوير,2019-03-26,5003,5000,5.996402157506215e-4,3
پكوير,2019-03-27,5027,5003,0.00477421921528263,24
پكوير,2019-03-30,5240,5027,0.040648854954074644,213
پكوير,2019-03-31,5498,5240,0.04692615495690684,258
پكوير,2019-04-06,5702,5498,0.035776920372539996,204
پكوير,2019-04-07,5970,5702,0.0448911222705375,268
پكوير,2019-04-08,5762,5970,0.03609857687676179,208
پكوير,2019-04-09,5631,5762,0.023264073872622255,131
پكوير,2019-04-10,5633,5631,3.5505059464671564e-4,2
پكوير,2019-04-13,5489,5633,0.02623428675054941,144
پكوير,2019-04-14,5427,5489,0.011424359680961053,62
پكوير,2019-04-15,5549,5427,0.021985943409265463,122
پكوير,2019-04-16,5470,5549,0.014442413160065372,79
پكوير,2019-04-17,5490,5470,0.0036429872488810584,20
پكوير,2019-04-20,5658,5490,0.02969247083250398,168
پكوير,2019-04-22,5792,5658,0.023135359112027732,134
پكوير,2019-04-23,6052,5792,0.04296100461947108,260
پكوير,2019-04-24,6354,6052,0.04752911551030388,302
پكوير,2019-04-27,6671,6354,0.04751911256970182,317
پكوير,2019-04-28,6967,6671,0.0424860054481863,296
پكوير,2019-04-29,6668,6967,0.04484103178691646,299
پكوير,2019-04-30,6406,6668,0.04089915703389023,262
پكوير,2019-05-01,6233,6406,0.027755494941800816,173
پكوير,2019-05-04,6538,6233,0.04665035178240282,305
پكوير,2019-05-05,6613,6538,0.011341297442712641,75
پكوير,2019-05-06,6305,6613,0.04885011894546389,308
پكوير,2019-05-07,6002,6305,0.05048317226749697,303
پكوير,2019-05-08,5874,6002,0.021790943135548017,128
پكوير,2019-05-11,6090,5874,0.03546798028974253,216
پكوير,2019-05-12,5843,6090,0.04227280505865603,247
پكوير,2019-05-13,6090,5843,0.040558292275770395,247
پكوير,2019-05-14,6389,6090,0.04679918609378632,299
پكوير,2019-05-15,6128,6389,0.04259138380506015,261
پكوير,2019-05-18,6385,6128,0.0402505873077133,257
پكوير,2019-05-19,6667,6385,0.04229788509940034,282
پكوير,2019-05-20,6411,6667,0.039931367955087914,256
پكوير,2019-05-21,6405,6411,9.367681497366481e-4,6
پكوير,2019-05-22,6462,6405,0.008820798513026803,57
پكوير,2019-05-25,6667,6462,0.030748462572259116,205
پكوير,2019-05-26,6689,6667,0.0032889819101077915,22
پكوير,2019-05-28,6575,6689,0.017338403039188075,114
پكوير,2019-05-29,6367,6575,0.032668446673053485,208
پكوير,2019-06-01,6178,6367,0.03059242472797144,189
پكوير,2019-06-02,6346,6178,0.02647336904719928,168
پكوير,2019-06-03,6351,6346,7.872775939557113e-4,5
پكوير,2019-06-08,6120,6351,0.03774509803304819,231
پكوير,2019-06-09,6406,6120,0.044645644701116816,286
پكوير,2019-06-10,6725,6406,0.04743494423086469,319
پكوير,2019-06-11,7052,6725,0.046369824156782494,327
پكوير,2019-06-12,7404,7052,0.04754186925343843,352
پكوير,2019-06-15,7733,7404,0.042544937276277645,329
پكوير,2019-06-16,7526,7733,0.027504650541123485,207
پكوير,2019-06-17,7162,7526,0.05082379222970904,364
پكوير,2019-06-18,7164,7162,2.791736459688479e-4,2
پكوير,2019-06-19,7059,7164,0.014874628132189456,105
پكوير,2019-06-22,6815,7059,0.03580337490303692,244
پكوير,2019-06-23,7134,6815,0.04471544714820361,319
پكوير,2019-06-25,7454,7134,0.04292997047988597,320
پكوير,2019-06-26,7171,7454,0.03946450982576147,283
پكوير,2019-06-30,7076,7171,0.01342566421517444,95
پكوير,2019-07-01,6802,7076,0.04028226991468946,274
پكوير,2019-07-02,6843,6802,0.005991524184423275,41
پكوير,2019-07-03,7041,6843,0.028121005534992045,198
پكوير,2019-07-06,6835,7041,0.03013899048571485,206
پكوير,2019-07-07,6843,6835,0.001169077889643566,8
پكوير,2019-07-08,6775,6843,0.010036900367522228,68
پكوير,2019-07-09,6612,6775,0.024652147606676927,163
پكوير,2019-07-10,6598,6612,0.0021218551072867756,14
پكوير,2019-07-13,6914,6598,0.0457043679424784,316
پكوير,2019-07-14,6909,6914,7.236937327075273e-4,5
پكوير,2019-07-15,6713,6909,0.02919708028762147,196
پكوير,2019-07-16,6415,6713,0.04645362431076327,298
پكوير,2019-07-17,6335,6415,0.012628255720184963,80
پكوير,2019-07-20,6213,6335,0.01963624657659162,122
پكوير,2019-07-21,6154,6213,0.009587260316934146,59
پكوير,2019-07-22,5877,6154,0.047132890922727086,277
پكوير,2019-07-23,5954,5877,0.012932482362624708,77
پكوير,2019-07-24,5982,5954,0.004680708792263339,28
پكوير,2019-07-27,6096,5982,0.01870078739850709,114
پكوير,2019-07-28,6108,6096,0.0019646365419180357,12
پكوير,2019-07-29,5967,6108,0.023629964802475284,141
پكوير,2019-07-30,5787,5967,0.031104199061499187,180
پكوير,2019-07-31,5861,5787,0.01262583176716843,74
پكوير,2019-08-03,5939,5861,0.013133524160105485,78
پكوير,2019-08-04,6180,5939,0.03899676374773515,241
پكوير,2019-08-05,6442,6180,0.04067059918648391,262
پكوير,2019-08-06,6205,6442,0.03819500402285334,237
پكوير,2019-08-07,6081,6205,0.020391382992864433,124
پكوير,2019-08-10,6354,6081,0.04296506137189722,273
پكوير,2019-08-11,6392,6354,0.005944931163024885,38
پكوير,2019-08-13,6398,6392,9.377930601847775e-4,6
پكوير,2019-08-14,6475,6398,0.011891891890055305,77
پكوير,2019-08-17,6382,6475,0.014572234406992755,93
پكوير,2019-08-18,6301,6382,0.012855102362663845,81
پكوير,2019-08-19,6391,6301,0.014082303236726285,90
پكوير,2019-08-21,6585,6391,0.02946089597122841,194
پكوير,2019-08-24,6874,6585,0.04204247889990653,289
پكوير,2019-08-25,6652,6874,0.03337342152234314,222
پكوير,2019-08-26,6675,6652,0.0034456928833789223,23
پكوير,2019-08-27,6653,6675,0.0033067788962412776,22
پكوير,2019-08-28,6533,6653,0.018368284093315736,120
پكوير,2019-08-31,6466,6533,0.010361892977055073,67
پكوير,2019-09-01,6551,6466,0.012975118300568597,85
پكوير,2019-09-02,6622,6551,0.010721836301612529,71
پكوير,2019-09-03,6822,6622,0.02931691585615407,200
پكوير,2019-09-04,7066,6822,0.03453155957620555,244
پكوير,2019-09-07,7360,7066,0.03994565216848564,294
پكوير,2019-09-08,7137,7360,0.031245621405177858,223
پكوير,2019-09-11,7262,7137,0.017212889008921387,125
پكوير,2019-09-14,7607,7262,0.045352964368955834,345
پكوير,2019-09-15,7955,7607,0.043746071647549206,348
پكوير,2019-09-16,8352,7955,0.047533524898523284,397
پكوير,2019-09-17,8668,8352,0.03645592985273928,316
پكوير,2019-09-18,8264,8668,0.04888673765139318,404
پكوير,2019-09-21,8006,8264,0.03222583062300451,258
پكوير,2019-09-22,7940,8006,0.008312342568222627,66
پكوير,2019-09-23,8274,7940,0.04036741599705494,334
پكوير,2019-09-24,7991,8274,0.03541484169247718,283
پكوير,2019-09-25,7896,7991,0.012031408306480317,95
پكوير,2019-09-28,8290,7896,0.04752714112816319,394
پكوير,2019-09-29,8563,8290,0.03188134999043777,273
پكوير,2019-09-30,8991,8563,0.04760315870897529,428
پكوير,2019-10-01,9117,8991,0.01382033563520672,126
پكوير,2019-10-02,8777,9117,0.03873760965720205,340
پكوير,2019-10-05,8989,8777,0.02358438090737742,212
پكوير,2019-10-06,8761,8989,0.026024426432367943,228
پكوير,2019-10-07,9100,8761,0.037252747248653545,339
پكوير,2019-10-08,8728,9100,0.042621448207765644,372
پكوير,2019-10-09,8334,8728,0.0472762178968951,394
پكوير,2019-10-12,8272,8334,0.007495164409151938,62
پكوير,2019-10-13,8299,8272,0.003253404024189251,27
پكوير,2019-10-14,7889,8299,0.05197109899201786,410
پكوير,2019-10-15,7555,7889,0.04420913301863545,334
پكوير,2019-10-16,7191,7555,0.05061882908488126,364
پكوير,2019-10-20,6864,7191,0.0476398601329196,327
پكوير,2019-10-21,6608,6864,0.03874092009098957,256
پكوير,2019-10-22,6640,6608,0.00481927710770794,32
پكوير,2019-10-23,6383,6640,0.04026319911636171,257
پكوير,2019-10-26,6317,6383,0.010447997465498179,66
پكوير,2019-10-28,6614,6317,0.044904747498502456,297
پكوير,2019-10-30,6875,6614,0.03796363635811438,261
پكوير,2019-11-02,6970,6875,0.013629842178819247,95
پكوير,2019-11-03,7105,6970,0.019000703727093497,135
پكوير,2019-11-04,6943,7105,0.02333285323011193,162
پكوير,2019-11-05,6948,6943,7.196315485435187e-4,5
پكوير,2019-11-09,7260,6948,0.042975206605650795,312
پكوير,2019-11-10,7567,7260,0.04057089995499261,307
پكوير,2019-11-11,7426,7567,0.018987341769595024,141
پكوير,2019-11-12,7571,7426,0.019152027470723545,145
پكوير,2019-11-13,7744,7571,0.022339876030173053,173
پكوير,2019-11-16,8131,7744,0.04759562168889489,387
پكوير,2019-11-17,7923,8131,0.026252682061560936,208
پكوير,2019-11-18,8308,7923,0.04634087625826422,385
پكوير,2019-11-19,8629,8308,0.03720013906162937,321
پكوير,2019-11-20,8395,8629,0.027873734362373587,234
پكوير,2019-11-23,8724,8395,0.03771205868435212,329
پكوير,2019-11-24,9160,8724,0.047598253269912856,436
پكوير,2019-11-25,9618,9160,0.047619047614096584,458
پكوير,2019-11-26,9620,9618,2.0790020787859665e-4,2
پكوير,2019-11-27,9429,9620,0.020256654998381942,191
پكوير,2019-11-30,9862,9429,0.04390590143541818,433
پكوير,2019-12-01,10355,9862,0.04760985030926027,493
پكوير,2019-12-02,10856,10355,0.04614959468992726,501
پكوير,2019-12-03,11245,10856,0.03459315250915134,389
پكوير,2019-12-04,11797,11245,0.04679155717158671,552
پكوير,2019-12-09,12582,11797,0.062390716892195934,785
پكوير,2019-12-10,11986,12582,0.049724678787775346,596
پكوير,2019-12-11,12549,11986,0.04486413259663207,563
پكوير,2019-12-14,11984,12549,0.04714619492263466,565
پكوير,2019-12-15,11480,11984,0.04390243902056599,504
پكوير,2019-12-16,11611,11480,0.011282404615340419,131
پكوير,2019-12-17,12168,11611,0.04577580538742802,557
پكوير,2019-12-18,12580,12168,0.03275039745367644,412
پكوير,2019-12-21,12434,12580,0.011741997747165675,146
پكوير,2019-12-22,11899,12434,0.04496176148878378,535
پكوير,2019-12-23,11766,11899,0.01130375658581474,133
پكوير,2019-12-24,11298,11766,0.041423260750449345,468
پكوير,2019-12-25,11372,11298,0.00650721069235779,74
پكوير,2019-12-28,11554,11372,0.015752120476393273,182
پكوير,2019-12-29,12011,11554,0.03804845557921501,457
پكوير,2019-12-30,12611,12011,0.04757751169236559,600
پكوير,2019-12-31,12568,12611,0.0034213876509053636,43
پكوير,2020-01-01,13128,12568,0.04265691651107123,560
پكوير,2020-01-04,12472,13128,0.052597819110599915,656
پكوير,2020-01-05,11849,12472,0.05257827664338102,623
پكوير,2020-01-07,11257,11849,0.05258949986207786,592
پكوير,2020-01-08,11118,11257,0.012502248604739858,139
پكوير,2020-01-11,11340,11118,0.019576719574993233,222
پكوير,2020-01-12,11755,11340,0.035304125900867366,415
پكوير,2020-01-13,11954,11755,0.01664714739696778,199
پكوير,2020-01-14,11467,11954,0.042469695644678666,487
پكوير,2020-01-15,11407,11467,0.005259928113854657,60
پكوير,2020-01-18,11956,11407,0.04591836734309816,549
پكوير,2020-01-19,12553,11956,0.04755835258125083,597
پكوير,2020-01-20,13180,12553,0.047572078903826094,627
پكوير,2020-01-21,13585,13180,0.029812292967993207,405
پكوير,2020-01-22,13360,13585,0.016841317364008884,225
پكوير,2020-01-25,13792,13360,0.03132250579819297,432
پكوير,2020-01-26,13805,13792,9.416877942092221e-4,13
پكوير,2020-01-27,13969,13805,0.011740282052277165,164
پكوير,2020-01-28,14056,13969,0.006189527603429885,87
پكوير,2020-02-01,14758,14056,0.047567421056541034,702
پكوير,2020-02-02,15495,14758,0.04756373023249024,737
پكوير,2020-02-03,16269,15495,0.047575142906904226,774
پكوير,2020-02-04,17010,16269,0.0435626102267159,741
پكوير,2020-02-05,17019,17010,5.288207297415347e-4,9
پكوير,2020-02-08,16398,17019,0.0378704720064721,621
پكوير,2020-02-09,16002,16398,0.024746906635123928,396
پكوير,2020-02-10,15630,16002,0.02380038387563657,372
پكوير,2020-02-12,16336,15630,0.04321743388569923,706
پكوير,2020-02-15,16628,16336,0.017560740917875826,292
پكوير,2020-02-16,16647,16628,0.0011413467891427075,19
پكوير,2020-02-17,16385,16647,0.015990234970034163,262
پكوير,2020-02-18,15722,16385,0.04217020735007186,663
پكوير,2020-02-19,16472,15722,0.045531811556245035,750
پكوير,2020-02-22,17295,16472,0.04758600751387187,823
پكوير,2020-02-23,18159,17295,0.04757971253661657,864
پكوير,2020-02-24,19066,18159,0.04757159340986197,907
پكوير,2020-02-25,20019,19066,0.04760477546093188,953
پكوير,2020-02-26,21002,20019,0.046805066181944334,983
پكوير,2020-02-29,21948,21002,0.04310187716224249,946
پكوير,2020-03-01,23045,21948,0.047602516812861685,1097
پكوير,2020-03-04,25363,23045,0.09139297401366585,2318
پكوير,2020-03-07,24657,25363,0.02863284259931732,706
پكوير,2020-03-09,24131,24657,0.021797687620828076,526
پكوير,2020-03-10,22962,24131,0.0509101994577602,1169
پكوير,2020-03-11,22677,22962,0.012567799972987265,285
پكوير,2020-03-14,21935,22677,0.033827216775298506,742
پكوير,2020-03-15,21218,21935,0.03379206334085248,717
پكوير,2020-03-16,22077,21218,0.03890927209136616,859
پكوير,2020-03-17,23096,22077,0.04412019397107204,1019
پكوير,2020-03-18,23743,23096,0.027250136881301852,647
پكوير,2020-03-24,23927,23743,0.00769005725717014,184
پكوير,2020-03-25,24684,23927,0.0306676389551666,757
پكوير,2020-03-28,25401,24684,0.028227235147111247,717
پكوير,2020-03-29,26309,25401,0.034512904328005134,908
پكوير,2020-03-30,27622,26309,0.04753457388865634,1313
پكوير,2020-04-04,28673,27622,0.03665469256664267,1051
پكوير,2020-04-05,30106,28673,0.04759848535017609,1433
پكوير,2020-04-06,31419,30106,0.04178999968039116,1313
پكوير,2020-04-07,32722,31419,0.03982030438115579,1303
پكوير,2020-04-08,34062,32722,0.03934002700841583,1340
پكوير,2020-04-13,37177,34062,0.08378836377104693,3115
پكوير,2020-04-14,38402,37177,0.0318993802397818,1225
پكوير,2020-04-25,13593,38402,1.8251305817828933,24809
پكوير,2020-04-26,14271,13593,0.04750893419889924,678
پكوير,2020-04-27,14927,14271,0.04394720975119266,656
پكوير,2020-04-28,15672,14927,0.04753700867486364,745
پكوير,2020-04-29,16422,15672,0.045670442087098376,750
پكوير,2020-05-02,17234,16422,0.04711616571619379,812
پكوير,2020-05-03,18089,17234,0.04726629443046789,855
پكوير,2020-05-04,18907,18089,0.04326439942649472,818
پكوير,2020-05-05,18775,18907,0.007030625831849234,132
پكوير,2020-05-06,18484,18775,0.01574334559533957,291
پكوير,2020-05-09,19392,18484,0.046823432340819746,908
پكوير,2020-05-10,20314,19392,0.04538741754231626,922
پكوير,2020-05-11,20758,20314,0.021389343866394194,444
پكوير,2020-05-16,19667,20758,0.05547363603724647,1091
پكوير,2020-05-17,19055,19667,0.032117554445966014,612
پكوير,2020-05-18,19343,19055,0.014889107169782914,288
پكوير,2020-05-19,20144,19343,0.03976370134830402,801
پكوير,2020-05-20,20966,20144,0.039206334062806145,822
پكوير,2020-05-23,20139,20966,0.04106460102085185,827
پكوير,2020-05-26,19963,20139,0.008816310173379938,176
پكوير,2020-05-27,18980,19963,0.051791359322877165,983
پكوير,2020-05-30,19860,18980,0.04431017119615759,880
پكوير,2020-06-01,21439,19860,0.07365082326257517,1579
پكوير,2020-06-02,20650,21439,0.038208232443670304,789
پكوير,2020-06-06,21271,20650,0.029194678198994184,621
پكوير,2020-06-07,22334,21271,0.04759559415923723,1063
پكوير,2020-06-08,23261,22334,0.039852112977092465,927
پكوير,2020-06-09,24353,23261,0.04484047139798626,1092
پكوير,2020-06-10,24889,24353,0.02153561814369659,536
پكوير,2020-06-13,25570,24889,0.026632772779560703,681
پكوير,2020-06-14,26760,25570,0.044469357247964525,1190
پكوير,2020-06-15,27900,26760,0.040860215052298914,1140
پكوير,2020-06-16,29290,27900,0.047456469783289296,1390
پكوير,2020-06-20,30750,29290,0.04747967479520391,1460
پكوير,2020-06-21,32250,30750,0.04651162790553452,1500
پكوير,2020-06-24,33920,32250,0.04923349056458628,1670
پكوير,2020-06-27,32650,33920,0.03889739662974281,1270
پكوير,2020-06-28,31410,32650,0.03947787328750468,1240
پكوير,2020-06-29,29840,31410,0.052613941017003556,1570
پكوير,2020-06-30,30200,29840,0.011920529800929783,360
پكوير,2020-07-01,31540,30200,0.04248573240195036,1340
پكوير,2020-07-04,30430,31540,0.03647716069548218,1110
پكوير,2020-07-05,29320,30430,0.03785811732476609,1110
پكوير,2020-07-06,28810,29320,0.017702186740100583,510
پكوير,2020-07-07,27470,28810,0.048780487803102277,1340
پكوير,2020-07-08,26250,27470,0.046476190474419955,1220
پكوير,2020-07-11,25260,26250,0.039192399048329676,990
پكوير,2020-07-12,26510,25260,0.0471520181045963,1250
پكوير,2020-07-13,26250,26510,0.009904761904384581,260
پكوير,2020-07-14,25230,26250,0.040428061829551006,1020
پكوير,2020-07-15,25000,25230,0.009199999999631999,230
پكوير,2020-07-19,27780,25000,0.10007199423685846,2780
پكوير,2020-07-20,27250,27780,0.019449541283689926,530
پكوير,2020-07-21,26170,27250,0.041268628198652325,1080
پكوير,2020-07-22,25470,26170,0.027483313701315928,700
پكوير,2020-07-25,24380,25470,0.04470877768479455,1090
پكوير,2020-07-26,23200,24380,0.05086206896332491,1180
پكوير,2020-07-27,22300,23200,0.04035874439280902,900
پكوير,2020-07-28,23330,22300,0.044149164164417096,1030
پكوير,2020-07-29,24490,23330,0.04736627194579966,1160
پكوير,2020-08-01,25200,24490,0.028174603173485135,710
پكوير,2020-08-02,26000,25200,0.030769230768047336,800
پكوير,2020-08-03,25020,26000,0.03916866506638015,980
پكوير,2020-08-04,23790,25020,0.051702395962517765,1230
پكوير,2020-08-09,22950,23790,0.03660130718794766,840
پكوير,2020-08-10,21850,22950,0.05034324942561358,1100
پكوير,2020-08-11,21380,21850,0.02198316183246103,470
پكوير,2020-08-12,20620,21380,0.0368574199788139,760
پكوير,2020-08-15,20090,20620,0.02638128421969232,530
پكوير,2020-08-16,19810,20090,0.014134275617661066,280
پكوير,2020-08-17,18860,19810,0.050371155882801104,950
پكوير,2020-08-18,19570,18860,0.036280020437594276,710
پكوير,2020-08-19,19240,19570,0.01715176715087569,330
پكوير,2020-08-22,18770,19240,0.02503995737746191,470
پكوير,2020-08-23,18550,18770,0.01185983827429327,220
پكوير,2020-08-24,18440,18550,0.005965292841325093,110
پكوير,2020-08-25,17770,18440,0.03770399549590861,670
پكوير,2020-08-26,17780,17770,5.624296962563313e-4,10
پكوير,2020-08-31,17690,17780,0.005087620124076449,90
پكوير,2020-09-01,17630,17690,0.0034032898466589173,60
پكوير,2020-09-02,17580,17630,0.002844141069235259,50
پكوير,2020-09-05,17100,17580,0.02807017543695496,480
پكوير,2020-09-06,16820,17100,0.01664684898830875,280
پكوير,2020-09-07,16800,16820,0.0011904761904053289,20
پكوير,2020-09-08,16790,16800,5.955926146161052e-4,10
پكوير,2020-09-09,16730,16790,0.0035863717869942394,60
سكرد,2018-01-16,811,803,0.009864364969341104,8
سكرد,2018-01-17,804,811,0.008706467650862602,7
سكرد,2018-01-20,789,804,0.01901140682001089,15
سكرد,2018-01-21,779,789,0.012836970458489127,10
سكرد,2018-01-22,777,779,0.0025740025706898293,2
سكرد,2018-01-23,777,777,0,0
سكرد,2018-01-24,801,777,0.029962546779072976,24
سكرد,2018-01-27,789,801,0.015209125456008714,12
سكرد,2018-01-28,783,789,0.0076628352392556385,6
سكرد,2018-01-29,771,783,0.015564202314443318,12
سكرد,2018-01-30,770,771,0.0012987012970146737,1
سكرد,2018-01-31,736,770,0.04619565211114721,34
سكرد,2018-02-03,713,736,0.032258064470886305,23
سكرد,2018-02-04,715,713,0.0027972027932906254,2
سكرد,2018-02-05,719,715,0.0055632823288410535,4
سكرد,2018-02-06,731,719,0.016415868650593888,12
سكرد,2018-02-07,728,731,0.0041208791152185726,3
سكرد,2018-02-10,726,728,0.002754820932844599,2
سكرد,2018-02-12,731,726,0.006839945271080786,5
سكرد,2018-02-13,747,731,0.021419009342143226,16
سكرد,2018-02-14,746,747,0.001340482571929648,1
سكرد,2018-02-17,746,746,0,0
سكرد,2018-02-18,779,746,0.04236200251301412,33
سكرد,2018-02-19,806,779,0.03349875926364918,27
سكرد,2018-02-21,790,806,0.02025316453132511,16
سكرد,2018-02-24,792,790,0.002525252522064075,2
سكرد,2018-02-25,787,792,0.006353240144405032,5
سكرد,2018-02-26,788,787,0.0012690355313844726,1
سكرد,2018-02-27,780,788,0.010256410243261013,8
سكرد,2018-02-28,775,780,0.006451612894901144,5
سكرد,2018-03-03,809,775,0.04202719401479951,34
سكرد,2018-03-04,810,809,0.00123456789971041,1
سكرد,2018-03-05,795,810,0.01886792450456865,15
سكرد,2018-03-06,794,795,0.0012594458422425115,1
سكرد,2018-03-07,795,794,0.0012578616336379098,1
سكرد,2018-03-10,799,795,0.005006257816012193,4
سكرد,2018-03-11,822,799,0.027980535245765773,23
سكرد,2018-03-12,813,822,0.011070110687490638,9
سكرد,2018-03-13,809,813,0.004944375766447001,4
سكرد,2018-03-14,841,809,0.03804994050172421,32
سكرد,2018-03-25,841,841,0,0
سكرد,2018-03-26,799,841,0.05256570706812803,42
سكرد,2018-03-27,837,799,0.04540023889438442,38
سكرد,2018-04-04,834,837,0.0035971222978451772,3
سكرد,2018-04-07,830,834,0.004819277102627377,4
سكرد,2018-04-08,809,830,0.025957972773846757,21
سكرد,2018-04-09,829,809,0.024125452323129733,20
سكرد,2018-04-15,827,829,0.0024183796826863606,2
سكرد,2018-04-16,826,827,0.0012106537515609518,1
سكرد,2018-04-17,819,826,0.008547008536572639,7
سكرد,2018-04-18,779,819,0.051347881833956506,40
سكرد,2018-04-21,769,779,0.013003901153440961,10
سكرد,2018-04-22,766,769,0.003916449081049022,3
سكرد,2018-04-23,783,766,0.02171136651122431,17
سكرد,2018-05-07,744,783,0.05241935476825355,39
سكرد,2018-05-08,712,744,0.04494382016159576,32
سكرد,2018-05-09,697,712,0.02152080341245222,15
سكرد,2018-05-12,693,697,0.005772005763676759,4
سكرد,2018-05-13,725,693,0.04413793097360286,32
سكرد,2018-05-14,756,725,0.0410052909510512,31
سكرد,2018-05-15,784,756,0.03571428566873178,28
سكرد,2018-05-16,772,784,0.015544041430642433,12
سكرد,2018-05-19,783,772,0.014048531271968671,11
سكرد,2018-05-20,756,783,0.0357142856670446,27
سكرد,2018-05-21,743,756,0.017496635238900896,13
سكرد,2018-05-22,730,743,0.017808219153687372,13
سكرد,2018-05-23,728,730,0.0027472527434790482,2
سكرد,2018-05-26,730,728,0.0027397260236442108,2
سكرد,2018-05-27,722,730,0.011080332394625579,8
سكرد,2018-05-28,716,722,0.00837988825645267,6
سكرد,2018-05-29,711,716,0.007032348794609918,5
سكرد,2018-05-30,711,711,0,0
سكرد,2018-06-02,740,711,0.039189189136230825,29
سكرد,2018-06-03,740,740,0,0
سكرد,2018-06-09,771,740,0.040207522645645234,31
سكرد,2018-06-10,794,771,0.028967254371577766,23
سكرد,2018-06-11,766,794,0.03655352475645754,28
سكرد,2018-06-12,764,766,0.0026178010436939776,2
سكرد,2018-06-13,755,764,0.011920529785535722,9
سكرد,2018-06-17,786,755,0.03944020351216259,31
سكرد,2018-06-18,785,786,0.0012738853486956875,1
سكرد,2018-06-19,748,785,0.04946524057558123,37
سكرد,2018-06-20,737,748,0.014925373114076834,11
سكرد,2018-06-23,754,737,0.022546419068240824,17
سكرد,2018-06-24,771,754,0.022049286612128034,17
سكرد,2018-06-25,762,771,0.011811023606547214,9
سكرد,2018-06-26,748,762,0.01871657751508479,14
سكرد,2018-06-27,743,748,0.006729475091884959,5
سكرد,2018-06-30,743,743,0,0
سكرد,2018-07-01,734,743,0.01226158036476624,9
سكرد,2018-07-02,724,734,0.013812154677055035,10
سكرد,2018-07-03,724,724,0,0
سكرد,2018-07-04,720,724,0.005555555547839507,4
سكرد,2018-07-07,702,720,0.025641025604499965,18
سكرد,2018-07-08,702,702,0,0
سكرد,2018-07-10,695,702,0.010071942431551162,7
سكرد,2018-07-11,679,695,0.02356406476647413,16
سكرد,2018-07-14,694,679,0.021613832821882086,15
سكرد,2018-07-15,699,694,0.007153075812370421,5
سكرد,2018-07-16,693,699,0.00865800864551514,6
سكرد,2018-07-17,693,693,0,0
سكرد,2018-07-18,694,693,0.0014409221881254723,1
سكرد,2018-07-21,719,694,0.034770514555256586,25
سكرد,2018-07-22,747,719,0.03748326634875065,28
سكرد,2018-07-23,738,747,0.012195121934694957,9
سكرد,2018-07-24,769,738,0.04031209357566698,31
سكرد,2018-07-25,800,769,0.0387499999515625,31
سكرد,2018-07-28,786,800,0.017811704811944395,14
سكرد,2018-07-29,758,786,0.036939313935436265,28
سكرد,2018-07-30,744,758,0.018817204275783327,14
سكرد,2018-07-31,777,744,0.042471042416382186,33
سكرد,2018-08-01,748,777,0.03877005342410421,29
سكرد,2018-08-04,741,748,0.009446693644471399,7
سكرد,2018-08-05,726,741,0.020661156996334494,15
سكرد,2018-08-06,719,726,0.009735744075471843,7
سكرد,2018-08-07,733,719,0.019099590696999194,14
سكرد,2018-08-08,739,733,0.008119079826631827,6
سكرد,2018-08-11,760,739,0.02763157891101108,21
سكرد,2018-08-12,759,760,0.0013175230549176244,1
سكرد,2018-08-13,759,759,0,0
سكرد,2018-08-14,750,759,0.011999999984,9
سكرد,2018-08-15,736,750,0.019021739104590027,14
سكرد,2018-08-18,767,736,0.040417209856040144,31
سكرد,2018-08-19,767,767,0,0
سكرد,2018-08-20,763,767,0.005242463951189431,4
سكرد,2018-08-21,760,763,0.003947368415858726,3
سكرد,2018-08-25,794,760,0.042821158636245395,34
سكرد,2018-08-26,827,794,0.03990326476432495,33
سكرد,2018-08-27,867,827,0.046136101446209804,40
سكرد,2018-08-28,904,867,0.04092920349454734,37
سكرد,2018-08-29,917,904,0.014176663016165035,13
سكرد,2018-09-01,980,917,0.06428571422011661,63
سكرد,2018-09-02,942,980,0.040339702717261464,38
سكرد,2018-09-03,911,942,0.03402854002850874,31
سكرد,2018-09-04,948,911,0.039029535823808505,37
سكرد,2018-09-05,956,948,0.008368200828066736,8
سكرد,2018-09-08,998,956,0.04208416829450484,42
سكرد,2018-09-09,1011,998,0.012858555872543465,13
سكرد,2018-09-10,1029,1011,0.01749271135326267,18
سكرد,2018-09-11,1039,1029,0.00962463906677128,10
سكرد,2018-09-12,1058,1039,0.01795841208132475,19
سكرد,2018-09-15,1082,1058,0.022181146005377867,24
سكرد,2018-09-16,1136,1082,0.04753521122576125,54
سكرد,2018-09-17,1191,1136,0.046179680901612355,55
سكرد,2018-09-18,1213,1191,0.01813685076823013,22
سكرد,2018-09-22,1221,1213,0.0065520065466404525,8
سكرد,2018-09-23,1231,1221,0.008123476841491895,10
سكرد,2018-09-24,1283,1231,0.040530007762642234,52
سكرد,2018-09-25,1291,1283,0.006196746703178352,8
سكرد,2018-09-26,1355,1291,0.04723247228986533,64
سكرد,2018-09-29,1368,1355,0.009502923969661604,13
سكرد,2018-09-30,1387,1368,0.013698630127109855,19
سكرد,2018-10-01,1456,1387,0.04739010985756174,69
سكرد,2018-10-02,1423,1456,0.023190442710337003,33
سكرد,2018-10-03,1462,1423,0.026675786575461158,39
سكرد,2018-10-06,1474,1462,0.008141112613201416,12
سكرد,2018-10-07,1437,1474,0.02574808627296584,37
سكرد,2018-10-08,1414,1437,0.01626591229401279,23
سكرد,2018-10-09,1359,1414,0.04047093448088967,55
سكرد,2018-10-10,1298,1359,0.046995377467646086,61
سكرد,2018-10-13,1258,1298,0.031796502359462235,40
سكرد,2018-10-14,1255,1258,0.0023904382451072205,3
سكرد,2018-10-15,1227,1255,0.022819885881972382,28
سكرد,2018-10-16,1202,1227,0.020798668867887962,25
سكرد,2018-10-17,1165,1202,0.031759656625099005,37
سكرد,2018-10-20,1218,1165,0.04351395727133501,53
سكرد,2018-10-21,1230,1218,0.009756097553043823,12
سكرد,2018-10-22,1183,1230,0.039729501234379114,47
سكرد,2018-10-23,1167,1183,0.013710368454404138,16
سكرد,2018-10-24,1127,1167,0.035492457821213436,40
سكرد,2018-10-27,1111,1127,0.014401440131051808,16
سكرد,2018-10-28,1110,1111,9.009009000892783e-4,1
سكرد,2018-10-29,1157,1110,0.04062229901415531,47
سكرد,2018-10-31,1192,1157,0.02936241608274965,35
سكرد,2018-11-03,1159,1192,0.02847282137318997,33
سكرد,2018-11-04,1134,1159,0.022045855359747922,25
سكرد,2018-11-05,1141,1134,0.006134969319776538,7
سكرد,2018-11-06,1118,1141,0.020572450786607823,23
سكرد,2018-11-10,1112,1118,0.005395683448385176,6
سكرد,2018-11-11,1097,1112,0.013673655411418727,15
سكرد,2018-11-12,1128,1097,0.02748226947918238,31
سكرد,2018-11-13,1143,1128,0.013123359568570988,15
سكرد,2018-11-14,1106,1143,0.03345388785401999,37
سكرد,2018-11-17,1075,1106,0.028837209275500267,31
سكرد,2018-11-18,1080,1075,0.004629629625342935,5
سكرد,2018-11-19,1081,1080,9.250693793477618e-4,1
سكرد,2018-11-20,1082,1081,9.242144168907444e-4,1
سكرد,2018-11-21,1092,1082,0.00915750914912316,10
سكرد,2018-11-24,1112,1092,0.017985611494617255,20
سكرد,2018-11-26,1103,1112,0.008159564815811817,9
سكرد,2018-11-27,1099,1103,0.0036396724261695424,4
سكرد,2018-11-28,1096,1099,0.0027372262748747932,3
سكرد,2018-12-01,1083,1096,0.012003693433052914,13
سكرد,2018-12-02,1053,1083,0.02849002846297243,30
سكرد,2018-12-03,1050,1053,0.0028571428544217686,3
سكرد,2018-12-04,1040,1050,0.009615384606139052,10
سكرد,2018-12-05,1020,1040,0.019607843118031525,20
سكرد,2018-12-08,1016,1020,0.00393700787014074,4
سكرد,2018-12-09,1066,1016,0.046904315152997825,50
سكرد,2018-12-10,1063,1066,0.002822201314372341,3
سكرد,2018-12-11,1067,1063,0.0037488284875831033,4
سكرد,2018-12-12,1059,1067,0.0075542964990044405,8
سكرد,2018-12-15,1041,1059,0.017291066265810694,18
سكرد,2018-12-16,1020,1041,0.020588235273933102,21
سكرد,2018-12-17,1017,1020,0.002949852504474088,3
سكرد,2018-12-18,1008,1017,0.008928571419713718,9
سكرد,2018-12-19,1004,1008,0.003984063741051729,4
سكرد,2018-12-22,960,1004,0.04583333328559028,44
سكرد,2018-12-23,950,960,0.010526315778393351,10
سكرد,2018-12-24,939,950,0.011714589976874771,11
سكرد,2018-12-25,908,939,0.03414096912539541,31
سكرد,2018-12-30,953,908,0.04721930740060933,45
سكرد,2018-12-31,999,953,0.046046045999953905,46
سكرد,2019-01-01,1048,999,0.046755725146225446,49
سكرد,2019-01-02,1013,1048,0.034550839057699075,35
سكرد,2019-01-05,988,1013,0.02530364369908538,25
سكرد,2019-01-06,954,988,0.03563941296054569,34
سكرد,2019-01-07,970,954,0.016494845343819748,16
سكرد,2019-01-08,981,970,0.011213047898865394,11
سكرد,2019-01-09,1005,981,0.023880596991163586,24
سكرد,2019-01-12,997,1005,0.008024072208601733,8
سكرد,2019-01-13,981,997,0.01630988785289512,16
سكرد,2019-01-14,983,981,0.00203458799386105,2
سكرد,2019-01-15,1013,983,0.029615004906599206,30
سكرد,2019-01-16,1060,1013,0.0443396225996796,47
سكرد,2019-01-19,1094,1060,0.031078610574882436,34
سكرد,2019-01-20,1104,1094,0.009057971006288069,10
سكرد,2019-01-21,1071,1104,0.03081232490120231,33
سكرد,2019-01-22,1115,1071,0.03946188337267992,44
سكرد,2019-01-23,1130,1115,0.013274336271438638,15
سكرد,2019-01-26,1083,1130,0.04339796856565284,47
سكرد,2019-01-27,1101,1083,0.01634877382711283,18
سكرد,2019-01-28,1151,1101,0.043440486495707656,50
سكرد,2019-01-29,1160,1151,0.007758620682966706,9
سكرد,2019-01-30,1215,1160,0.04526748967467696,55
سكرد,2019-02-02,1208,1215,0.005794701981958027,7
سكرد,2019-02-03,1149,1208,0.051348999084987815,59
سكرد,2019-02-04,1159,1149,0.008628127688845445,10
سكرد,2019-02-05,1107,1159,0.046973803028930616,52
سكرد,2019-02-06,1115,1107,0.007174887885941804,8
سكرد,2019-02-10,1131,1115,0.014146772754954223,16
سكرد,2019-02-12,1181,1131,0.04233700250437171,50
سكرد,2019-02-13,1221,1181,0.032760032733202264,40
سكرد,2019-02-16,1196,1221,0.02090301001596738,25
سكرد,2019-02-17,1159,1196,0.03192407244872815,37
سكرد,2019-02-18,1157,1159,0.0017286084686874601,2
سكرد,2019-02-19,1106,1157,0.0461121156906762,51
سكرد,2019-02-20,1105,1106,9.049773747466267e-4,1
سكرد,2019-02-23,1084,1105,0.019372693709065778,21
سكرد,2019-02-24,1089,1084,0.004591368223515731,5
سكرد,2019-02-25,1072,1089,0.015858208940430774,17
سكرد,2019-02-26,1060,1072,0.011320754706301174,12
سكرد,2019-02-27,1071,1060,0.010270774967067436,11
سكرد,2019-03-02,1073,1071,0.001863932896678534,2
سكرد,2019-03-03,1053,1073,0.018993352308648286,20
سكرد,2019-03-04,1064,1053,0.010338345854945162,11
سكرد,2019-03-05,1059,1064,0.004721435311877776,5
سكرد,2019-03-06,1060,1059,9.433962255250978e-4,1
سكرد,2019-03-09,1062,1060,0.0018832391696014695,2
سكرد,2019-03-10,1071,1062,0.008403361336691539,9
سكرد,2019-03-11,1089,1071,0.016528925604656634,18
سكرد,2019-03-12,1085,1089,0.0036866359413026393,4
سكرد,2019-03-13,1099,1085,0.0127388534915934,14
سكرد,2019-03-16,1134,1099,0.03086419750364709,35
سكرد,2019-03-17,1133,1134,8.82612532318965e-4,1
سكرد,2019-03-18,1171,1133,0.03245089664180111,38
سكرد,2019-03-19,1163,1171,0.006878761816957212,8
سكرد,2019-03-25,1159,1163,0.0034512510755381784,4
سكرد,2019-03-26,1206,1159,0.038971807596209114,47
سكرد,2019-03-27,1253,1206,0.037509976027525954,47
سكرد,2019-03-30,1310,1253,0.043511450348464535,57
سكرد,2019-03-31,1340,1310,0.02238805968478503,30
سكرد,2019-04-06,1362,1340,0.01615271658138567,22
سكرد,2019-04-07,1396,1362,0.02435530084215236,34
سكرد,2019-04-08,1451,1396,0.03790489315099593,55
سكرد,2019-04-09,1514,1451,0.04161162480738994,63
سكرد,2019-04-10,1589,1514,0.04719949650899968,75
سكرد,2019-04-13,1649,1589,0.036385688273871626,60
سكرد,2019-04-16,1566,1649,0.05300127710536316,83
سكرد,2019-04-17,1619,1566,0.032736256928513736,53
سكرد,2019-04-20,1699,1619,0.04708652145551117,80
سكرد,2019-04-22,1779,1699,0.04496908372964076,80
سكرد,2019-04-23,1850,1779,0.03837837835763331,71
سكرد,2019-04-24,1857,1850,0.0037695207303341297,7
سكرد,2019-04-27,1787,1857,0.03917179628473878,70
سكرد,2019-04-28,1777,1787,0.005627462011464568,10
سكرد,2019-04-29,1789,1777,0.006707657905697228,12
سكرد,2019-04-30,1865,1789,0.04075067021943664,76
سكرد,2019-05-01,1955,1865,0.04603580560305073,90
سكرد,2019-05-04,2033,1955,0.0383669453820133,78
سكرد,2019-05-05,2119,2033,0.040585181670323184,86
سكرد,2019-05-06,2161,2119,0.019435446543528252,42
سكرد,2019-05-07,2158,2161,0.0013901760883270732,3
سكرد,2019-05-08,2258,2158,0.044286979608376006,100
سكرد,2019-05-11,2359,2258,0.04281475199541554,101
سكرد,2019-05-12,2334,2359,0.010711225359592449,25
سكرد,2019-05-13,2319,2334,0.006468305301221085,15
سكرد,2019-05-14,2307,2319,0.005201560465885756,12
سكرد,2019-05-15,2222,2307,0.03825382536532231,85
سكرد,2019-05-18,2302,2222,0.03475238921166274,80
سكرد,2019-05-19,2216,2302,0.038808664242414866,86
سكرد,2019-05-20,2114,2216,0.04824976345872765,102
سكرد,2019-05-21,2093,2114,0.010033444811259703,21
سكرد,2019-05-22,2176,2093,0.03814338233541205,83
سكرد,2019-05-25,2220,2176,0.019819819810891974,44
سكرد,2019-05-26,2314,2220,0.04062229903171033,94
سكرد,2019-05-28,2358,2314,0.01865988124738767,44
سكرد,2019-05-29,2250,2358,0.04799999997866667,108
سكرد,2019-06-01,2152,2250,0.04553903343608781,98
سكرد,2019-06-02,2220,2152,0.030630630616833052,68
سكرد,2019-06-03,2232,2220,0.0053763440836127495,12
سكرد,2019-06-08,2296,2232,0.027874564447789824,64
سكرد,2019-06-09,2409,2296,0.046907430449602563,113
سكرد,2019-06-10,2519,2409,0.04366812225340686,110
سكرد,2019-06-11,2634,2519,0.043659832937107124,115
سكرد,2019-06-12,2758,2634,0.044960116009804166,124
سكرد,2019-06-18,2588,2758,0.06568778977369097,170
سكرد,2019-06-19,2471,2588,0.047349251296095005,117
سكرد,2019-06-22,2429,2471,0.017291066275302157,42
سكرد,2019-06-23,2384,2429,0.01887583891825678,45
سكرد,2019-06-24,2438,2384,0.02214930269805197,54
سكرد,2019-06-25,2375,2438,0.02652631577830471,63
سكرد,2019-06-26,2493,2375,0.04733253106805755,118
سكرد,2019-06-30,2593,2493,0.038565368284394386,100
سكرد,2019-07-01,2488,2593,0.04220257233030444,105
سكرد,2019-07-02,2507,2488,0.007578779414607588,19
سكرد,2019-07-03,2459,2507,0.019520130126262657,48
سكرد,2019-07-06,2381,2459,0.03275934479934509,78
سكرد,2019-07-07,2302,2381,0.03431798434651695,79
سكرد,2019-07-08,2320,2302,0.007758620686310939,18
سكرد,2019-07-09,2217,2320,0.04645917904986054,103
سكرد,2019-07-10,2254,2217,0.01641526174959394,37
سكرد,2019-07-13,2272,2254,0.007922535207780575,18
سكرد,2019-07-16,2159,2272,0.052339045830320036,113
سكرد,2019-07-17,2080,2159,0.03798076921250925,79
سكرد,2019-07-20,2092,2080,0.005736137664562076,12
سكرد,2019-07-21,2172,2092,0.03683241250606243,80
سكرد,2019-07-22,2213,2172,0.01852688657093227,41
سكرد,2019-07-23,2174,2213,0.017939282420451112,39
سكرد,2019-07-24,2182,2174,0.003666361134891677,8
سكرد,2019-07-27,2152,2182,0.013940520439618718,30
سكرد,2019-07-28,2177,2152,0.011483693150443872,25
سكرد,2019-07-29,2178,2177,4.591368225623798e-4,1
سكرد,2019-07-30,2254,2178,0.03371783494511187,76
سكرد,2019-07-31,2286,2254,0.013998250212599192,32
سكرد,2019-08-03,2250,2286,0.01599999999288889,36
سكرد,2019-08-04,2209,2250,0.018560434577383236,41
سكرد,2019-08-05,2283,2209,0.032413491006389183,74
سكرد,2019-08-06,2387,2283,0.043569333873661784,104
سكرد,2019-08-07,2408,2387,0.008720930228936491,21
سكرد,2019-08-10,2391,2408,0.00710999581467587,17
سكرد,2019-08-11,2382,2391,0.0037783375298999426,9
سكرد,2019-08-13,2494,2382,0.044907778650798806,112
سكرد,2019-08-14,2611,2494,0.044810417447410794,117
سكرد,2019-08-17,2649,2611,0.014345035857174393,38
سكرد,2019-08-18,2740,2649,0.03321167881999574,91
سكرد,2019-08-19,2867,2740,0.044297174731671725,127
سكرد,2019-08-21,2979,2867,0.03759650888298204,112
سكرد,2019-08-24,3126,2979,0.04702495200031192,147
سكرد,2019-08-25,3082,3126,0.014276443862986229,44
سكرد,2019-08-26,3177,3082,0.029902423660716895,95
سكرد,2019-08-27,3060,3177,0.03823529410515187,117
سكرد,2019-08-28,2967,3060,0.03134479270935464,93
سكرد,2019-08-31,3084,2967,0.03793774317836001,117
سكرد,2019-09-01,3044,3084,0.013140604463488633,40
سكرد,2019-09-02,2932,3044,0.0381991814330835,112
سكرد,2019-09-03,2899,2932,0.011383235594555629,33
سكرد,2019-09-04,3002,2899,0.03431045968210844,103
سكرد,2019-09-07,3146,3002,0.04577240939422365,144
سكرد,2019-09-08,3237,3146,0.028112449790512063,91
سكرد,2019-09-11,3303,3237,0.019981834689681552,66
سكرد,2019-09-16,3521,3303,0.061914228894656566,218
سكرد,2019-09-17,3389,3521,0.038949542626453365,132
سكرد,2019-09-18,3239,3389,0.04631058967387756,150
سكرد,2019-09-21,3332,3239,0.027911164457409616,93
سكرد,2019-09-22,3462,3332,0.037550548804866975,130
سكرد,2019-09-23,3486,3462,0.006884681581501813,24
سكرد,2019-09-24,3346,3486,0.041841004171595635,140
سكرد,2019-09-25,3354,3346,0.0023852116868261146,8
سكرد,2019-09-28,3373,3354,0.005632967682883793,19
سكرد,2019-09-29,3348,3373,0.007467144561688428,25
سكرد,2019-09-30,3349,3348,2.9859659590964567e-4,1
سكرد,2019-10-01,3277,3349,0.021971315220637378,72
سكرد,2019-10-02,3251,3277,0.007997539216241913,26
سكرد,2019-10-05,3276,3251,0.007631257628928188,25
سكرد,2019-10-06,3300,3276,0.007272727270523416,24
سكرد,2019-10-07,3268,3300,0.00979192166163038,32
سكرد,2019-10-08,3125,3268,0.0457599999853568,143
سكرد,2019-10-09,2976,3125,0.05006720428425161,149
سكرد,2019-10-12,2971,2976,0.001682935038141052,5
سكرد,2019-10-13,2974,2971,0.0010087424340925546,3
سكرد,2019-10-14,2837,2974,0.04829044763895296,137
سكرد,2019-10-15,2728,2837,0.03995601171555865,109
سكرد,2019-10-16,2614,2728,0.04361132362524433,114
سكرد,2019-10-20,2579,2614,0.013571151603888658,35
سكرد,2019-10-21,2508,2579,0.028309409877069616,71
سكرد,2019-10-22,2476,2508,0.012924071077171216,32
سكرد,2019-10-23,2363,2476,0.04782056705551394,113
سكرد,2019-10-26,2250,2363,0.05022222219990124,113
سكرد,2019-10-28,2331,2250,0.0347490347341274,81
سكرد,2019-10-30,2447,2331,0.04740498567739886,116
سكرد,2019-11-02,2531,2447,0.033188463044967025,84
سكرد,2019-11-03,2613,2531,0.031381553757603695,82
سكرد,2019-11-04,2502,2613,0.04436450837555376,111
سكرد,2019-11-05,2435,2502,0.027515400399377662,67
سكرد,2019-11-09,2435,2435,0,0
سكرد,2019-11-10,2410,2435,0.010373443979098156,25
سكرد,2019-11-11,2486,2410,0.03057119870049429,76
سكرد,2019-11-12,2520,2486,0.0134920634867095,34
سكرد,2019-11-13,2614,2520,0.03596021421730673,94
سكرد,2019-11-16,2629,2614,0.005705591477479806,15
سكرد,2019-11-17,2513,2629,0.04615996814717073,116
سكرد,2019-11-18,2457,2513,0.022792022782746432,56
سكرد,2019-11-19,2472,2457,0.006067961162593867,15
سكرد,2019-11-25,2690,2472,0.08104089216318183,218
سكرد,2019-11-26,2697,2690,0.00259547645435837,7
سكرد,2019-11-27,2760,2697,0.022826086948251417,63
سكرد,2019-11-30,2896,2760,0.0469613259506349,136
سكرد,2019-12-01,2999,2896,0.03434478158241255,103
سكرد,2019-12-02,2894,2999,0.036281962668872854,105
سكرد,2019-12-03,2895,2894,3.454231432312874e-4,1
سكرد,2019-12-04,2983,2895,0.02950050283959085,88
سكرد,2019-12-07,3057,2983,0.024206738624727924,74
سكرد,2019-12-08,3066,3057,0.002935420742682511,9
سكرد,2019-12-09,3047,3066,0.006235641612656501,19
سكرد,2019-12-10,2999,3047,0.01600533510636701,48
سكرد,2019-12-11,3107,2999,0.03476021884944956,108
سكرد,2019-12-14,3262,3107,0.04751686080701507,155
سكرد,2019-12-15,3422,3262,0.046756282861847964,160
سكرد,2019-12-16,3592,3422,0.047327394196178346,170
سكرد,2019-12-17,3771,3592,0.04746751523535733,179
سكرد,2019-12-18,3959,3771,0.047486739063529494,188
سكرد,2019-12-21,3998,3959,0.009754877436279421,39
سكرد,2019-12-22,4105,3998,0.02606577344066607,107
سكرد,2019-12-23,4096,4105,0.002197265624463558,9
سكرد,2019-12-24,3980,4096,0.029145728635893035,116
سكرد,2019-12-25,3828,3980,0.03970741900739096,152
سكرد,2019-12-28,4004,3828,0.04395604394506592,176
سكرد,2019-12-29,4137,4004,0.032148900161433666,133
سكرد,2019-12-30,4317,4137,0.04169562195003576,180
سكرد,2019-12-31,4342,4317,0.00575771533722761,25
سكرد,2020-01-01,4281,4342,0.014249007237970332,61
سكرد,2020-01-04,4191,4281,0.021474588398598282,90
سكرد,2020-01-05,4026,4191,0.040983606547197314,165
سكرد,2020-01-07,3870,4026,0.04031007750896381,156
سكرد,2020-01-08,3863,3870,0.001812063162875469,7
سكرد,2020-01-11,3940,3863,0.019543147203161637,77
سكرد,2020-01-12,4108,3940,0.04089581303775661,168
سكرد,2020-01-13,4189,4108,0.019336357121189696,81
سكرد,2020-01-14,4025,4189,0.04074534160478377,164
سكرد,2020-01-15,3920,4025,0.026785714278881195,105
سكرد,2020-01-18,4064,3920,0.03543307085742296,144
سكرد,2020-01-19,4068,4064,9.832841688831651e-4,4
سكرد,2020-01-20,4170,4068,0.024460431648810448,102
سكرد,2020-01-21,4353,4170,0.042039972423147255,183
سكرد,2020-01-22,4550,4353,0.043296703287187537,197
سكرد,2020-01-25,4777,4550,0.04751936360738552,227
سكرد,2020-01-26,4857,4777,0.01647107267521699,80
سكرد,2020-01-27,4742,4857,0.02425137072453577,115
سكرد,2020-01-28,4588,4742,0.03356582388108853,154
سكرد,2020-02-01,4768,4588,0.03775167784443127,180
سكرد,2020-02-02,4959,4768,0.03851582979662919,191
سكرد,2020-02-03,5205,4959,0.04726224782953655,246
سكرد,2020-02-04,5111,5205,0.018391704163883447,94
سكرد,2020-02-05,5102,5111,0.0017640141117671474,9
سكرد,2020-02-08,4987,5102,0.02305995588067777,115
سكرد,2020-02-09,5156,4987,0.03277734677409283,169
سكرد,2020-02-10,4944,5156,0.04288025889100318,212
سكرد,2020-02-12,4995,4944,0.010210210208166124,51
سكرد,2020-02-15,4906,4995,0.01814105176964104,89
سكرد,2020-02-16,4896,4906,0.002042483659713545,10
سكرد,2020-02-17,4751,4896,0.03051989054293414,145
سكرد,2020-02-18,4583,4751,0.036657211425560284,168
سكرد,2020-02-19,4806,4583,0.04640033290753218,223
سكرد,2020-02-22,4992,4806,0.037259615377151514,186
سكرد,2020-02-23,5241,4992,0.04751001716323029,249
سكرد,2020-02-24,5493,5241,0.04587657017187756,252
سكرد,2020-02-25,5767,5493,0.047511704517511404,274
سكرد,2020-02-26,6022,5767,0.04234473596108523,255
سكرد,2020-02-29,5738,6022,0.04949459741207832,284
سكرد,2020-03-01,5989,5738,0.04191016863551341,251
سكرد,2020-03-02,6224,5989,0.03775706940267399,235
سكرد,2020-03-03,6493,6224,0.041429231473674846,269
سكرد,2020-03-04,6772,6493,0.041199054925989506,279
سكرد,2020-03-07,6476,6772,0.04570722667607979,296
سكرد,2020-03-09,6349,6476,0.020003150099227728,127
سكرد,2020-03-10,6296,6349,0.00841804320069599,53
سكرد,2020-03-11,6256,6296,0.0063938618915610835,40
سكرد,2020-03-14,6205,6256,0.008219178080867175,51
سكرد,2020-03-15,6173,6205,0.0051838652186645285,32
سكرد,2020-03-16,6035,6173,0.022866611429516716,138
سكرد,2020-03-17,5905,6035,0.02201524131718624,130
سكرد,2020-03-18,5810,5905,0.016351118757943008,95
سكرد,2020-03-24,5714,5810,0.016800840039061807,96
سكرد,2020-03-25,5849,5714,0.023080868520587983,135
سكرد,2020-03-28,5904,5849,0.009315718155603706,55
سكرد,2020-03-29,6117,5904,0.03482099067601422,213
سكرد,2020-03-30,6398,6117,0.043919974985320416,281
سكرد,2020-04-04,6599,6398,0.03045916047424471,201
سكرد,2020-04-05,6793,6599,0.02855881053605788,194
سكرد,2020-04-06,7055,6793,0.037136782418549,262
سكرد,2020-04-07,7224,7055,0.023394241414258825,169
سكرد,2020-04-08,7304,7224,0.010952902517668003,80
سكرد,2020-04-11,7625,7304,0.042098360650216604,321
سكرد,2020-04-12,7865,7625,0.030514939601968855,240
سكرد,2020-04-13,8213,7865,0.04237184950172022,348
سكرد,2020-04-14,8394,8213,0.021563021203054204,181
سكرد,2020-04-15,8503,8394,0.012819005055531105,109
سكرد,2020-04-18,8572,8503,0.008049463368169684,69
سكرد,2020-04-21,9375,8572,0.08565333332419697,803
سكرد,2020-04-22,9499,9375,0.013054005683434676,124
سكرد,2020-04-25,9704,9499,0.021125309148688654,205
سكرد,2020-04-26,10149,9704,0.04384668439808388,445
سكرد,2020-04-27,10656,10149,0.047578828824363845,507
سكرد,2020-04-28,11182,10656,0.047039885526109826,526
سكرد,2020-04-29,11540,11182,0.031022530326601166,358
سكرد,2020-05-02,12117,11540,0.047619047615117684,577
سكرد,2020-05-03,12722,12117,0.04755541581138536,605
سكرد,2020-05-04,13167,12722,0.0337966127414144,445
سكرد,2020-05-05,13122,13167,0.003429355280945789,45
سكرد,2020-05-06,13200,13122,0.005909090908643251,78
سكرد,2020-05-09,13850,13200,0.046931407938849715,650
سكرد,2020-05-10,14064,13850,0.015216154720192252,214
سكرد,2020-05-12,12958,14064,0.08535267787580239,1106
سكرد,2020-05-13,12689,12958,0.021199464101095477,269
سكرد,2020-05-16,12483,12689,0.016502443321597175,206
سكرد,2020-05-17,12235,12483,0.020269718020411137,248
سكرد,2020-05-18,12320,12235,0.006899350648790637,85
سكرد,2020-05-19,11881,12320,0.036949751701292,439
سكرد,2020-05-20,11467,11881,0.036103601636338745,414
سكرد,2020-05-23,11103,11467,0.032783932267604794,364
سكرد,2020-05-26,10726,11103,0.035148237923256734,377
سكرد,2020-05-27,10903,10726,0.016234064017588364,177
سكرد,2020-05-30,11371,10903,0.04115733004650802,468
سكرد,2020-05-31,11790,11371,0.03553859202412735,419
سكرد,2020-06-01,12342,11790,0.04472532814416421,552
سكرد,2020-06-02,12959,12342,0.047611698429847076,617
سكرد,2020-06-06,13134,12959,0.013324196740267687,175
سكرد,2020-06-07,13790,13134,0.047570703404817206,656
سكرد,2020-06-08,14473,13790,0.04719132176831401,683
سكرد,2020-06-09,15196,14473,0.047578310078469445,723
سكرد,2020-06-10,15955,15196,0.04757129426213906,759
سكرد,2020-06-13,16550,15955,0.035951661629247636,595
سكرد,2020-06-14,17350,16550,0.046109510083797725,800
سكرد,2020-06-20,17370,17350,0.001151410477769061,20
سكرد,2020-06-21,16510,17370,0.05208964263766871,860
سكرد,2020-06-22,17170,16510,0.038439138029211464,660
سكرد,2020-06-23,17520,17170,0.01997716894863144,350
سكرد,2020-06-24,16790,17520,0.04347826086697568,730
سكرد,2020-06-27,16330,16790,0.028169014082782055,460
سكرد,2020-06-28,15630,16330,0.0447856685831871,700
سكرد,2020-06-29,14990,15630,0.042695130083876244,640
سكرد,2020-06-30,15550,14990,0.036012861734018464,560
سكرد,2020-07-04,15810,15550,0.016445287791496187,260
سكرد,2020-07-05,15340,15810,0.03063885267075366,470
سكرد,2020-07-06,15390,15340,0.003248862897774603,50
سكرد,2020-07-07,14690,15390,0.047651463577423316,700
سكرد,2020-07-08,14050,14690,0.04555160142024544,640
سكرد,2020-07-11,13560,14050,0.03613569321267436,490
سكرد,2020-07-12,14230,13560,0.04708362613864486,670
سكرد,2020-07-13,14820,14230,0.03981106612416929,590
سكرد,2020-07-14,15390,14820,0.037037037034630474,570
سكرد,2020-07-15,15580,15390,0.01219512195043677,190
سكرد,2020-07-18,16120,15580,0.03349875930313283,540
سكرد,2020-07-19,16920,16120,0.04728132387427415,800
سكرد,2020-07-20,17120,16920,0.011682242989971831,200
سكرد,2020-07-21,16320,17120,0.0490196078401336,800
سكرد,2020-07-22,15600,16320,0.04615384615088757,720
سكرد,2020-07-25,15020,15600,0.038615179757748655,580
سكرد,2020-07-26,14310,15020,0.04961565338577109,710
سكرد,2020-07-27,13610,14310,0.051432770018263574,700
سكرد,2020-07-28,13360,13610,0.01871257484889876,250
سكرد,2020-07-29,12970,13360,0.030069390899763345,390
سكرد,2020-08-01,13430,12970,0.034251675351135394,460
سكرد,2020-08-02,14100,13430,0.047517730493083846,670
سكرد,2020-08-03,14060,14100,0.0028449502131689224,40
سكرد,2020-08-04,13490,14060,0.04225352112362835,570
سكرد,2020-08-05,13530,13490,0.0029563932000771327,40
سكرد,2020-08-09,13080,13530,0.034403669722140394,450
سكرد,2020-08-10,12440,13080,0.05144694533348497,640
سكرد,2020-08-11,11850,12440,0.04978902953166337,590
سكرد,2020-08-12,11670,11850,0.015424164523099899,180
سكرد,2020-08-15,11520,11670,0.013020833332203052,150
سكرد,2020-08-16,12080,11520,0.04635761589020218,560
سكرد,2020-08-17,12340,12080,0.02106969205663941,260
سكرد,2020-08-18,12720,12340,0.029874213834129384,380
سكرد,2020-08-19,12650,12720,0.005533596837507225,70
سكرد,2020-08-22,12470,12650,0.014434643142386957,180
سكرد,2020-08-23,12290,12470,0.014646053701005203,180
سكرد,2020-08-24,12180,12290,0.009031198685629621,110
سكرد,2020-08-25,11910,12180,0.022670025187013432,270
سكرد,2020-08-26,12380,11910,0.03796445880145683,470
سكرد,2020-08-31,12210,12380,0.013923013921873627,170
سكرد,2020-09-01,12200,12210,8.196721310803547e-4,10
سكرد,2020-09-02,12190,12200,8.203445446414812e-4,10
سكرد,2020-09-05,12150,12190,0.003292181069687886,40
سكرد,2020-09-06,12140,12150,8.237232289272056e-4,10
سكرد,2020-09-07,12130,12140,8.244023082584994e-4,10
سكرد,2020-09-08,12130,12130,0,0
سكرد,2020-09-09,12050,12130,0.006639004148826638,80
داسوهح,2018-02-12,4837,4700,0.028323340907933977,137
داسوهح,2018-02-13,4629,4837,0.04493411102939423,208
داسوهح,2018-02-14,4709,4629,0.016988744952858622,80
داسوهح,2018-02-17,4538,4709,0.03768179814066069,171
داسوهح,2018-02-18,4498,4538,0.008892841260806392,40
داسوهح,2018-02-19,4529,4498,0.006844778095198767,31
داسوهح,2018-02-24,4503,4529,0.005773928490834126,26
داسوهح,2018-02-25,4508,4503,0.0011091393076510339,5
داسوهح,2018-02-26,4505,4508,6.659267479098941e-4,3
داسوهح,2018-02-27,4433,4505,0.01624182268977175,72
داسوهح,2018-02-28,4424,4433,0.002034358046556429,9
داسوهح,2018-03-03,4392,4424,0.007285974497430333,32
داسوهح,2018-03-04,4329,4392,0.014553014549652802,63
داسوهح,2018-03-05,4367,4329,0.008701625828096719,38
داسوهح,2018-03-06,4315,4367,0.012050984933476016,52
داسوهح,2018-03-07,4256,4315,0.013862781951629984,59
داسوهح,2018-03-10,4250,4256,0.001411764705550173,6
داسوهح,2018-03-11,4362,4250,0.02567629527150933,112
داسوهح,2018-03-12,4294,4362,0.01583605029906007,68
داسوهح,2018-03-13,4265,4294,0.006799531065228714,29
داسوهح,2018-03-14,4277,4265,0.0028057049327085094,12
داسوهح,2018-03-17,4310,4277,0.007656612527225843,33
داسوهح,2018-09-18,7100,4310,0.39295774642352704,2790
داسوهح,2018-09-22,7100,7100,0,0
داسوهح,2018-09-23,7100,7100,0,0
داسوهح,2018-09-25,7100,7100,0,0
داسوهح,2018-09-26,7100,7100,0,0
داسوهح,2018-09-29,7100,7100,0,0
داسوهح,2018-09-30,7100,7100,0,0
داسوهح,2018-10-01,7100,7100,0,0
داسوهح,2018-10-02,7100,7100,0,0
داسوهح,2018-10-09,7100,7100,0,0
داسوهح,2018-10-13,6390,7100,0.11111111109372282,710
داسوهح,2018-10-15,6277,6390,0.018002230361955994,113
داسوهح,2018-10-16,6000,6277,0.04616666665897222,277
داسوهح,2018-10-17,5623,6000,0.06704606080970192,377
داسوهح,2018-10-20,5409,5623,0.03956369013873846,214
داسوهح,2018-10-21,5038,5409,0.073640333451044,371
داسوهح,2018-10-22,4621,5038,0.09024020772771256,417
داسوهح,2018-10-23,4286,4621,0.07816145588470334,335
داسوهح,2018-10-24,3905,4286,0.09756722148589828,381
داسوهح,2018-10-27,3545,3905,0.10155148093045092,360
داسوهح,2018-10-28,3335,3545,0.06296851572324783,210
دالبر,2018-01-15,7684,7918,0.030452889116286713,234
دالبر,2018-01-16,7670,7684,0.0018252933504791012,14
دالبر,2018-01-17,7638,7670,0.0041895784231226006,32
دالبر,2018-01-20,7753,7638,0.014832967881486784,115
دالبر,2018-01-21,7677,7753,0.009899700402514042,76
دالبر,2018-01-22,7754,7677,0.009930358523351772,77
دالبر,2018-01-23,7850,7754,0.012229299361499451,96
دالبر,2018-01-24,7917,7850,0.008462801565180901,67
دالبر,2018-01-27,8011,7917,0.011733865932875563,94
دالبر,2018-01-28,8002,8011,0.0011247188201543715,9
دالبر,2018-01-29,7946,8002,0.007047571104071536,56
دالبر,2018-01-30,7939,7946,8.817231388233123e-4,7
دالبر,2018-01-31,7938,7939,1.2597631643663688e-4,1
دالبر,2018-02-03,7929,7938,0.0011350737796525319,9
دالبر,2018-02-04,7928,7929,1.2613521693666306e-4,1
دالبر,2018-02-05,7926,7928,2.523340903037681e-4,2
دالبر,2018-02-06,7904,7926,0.002783400809364448,22
دالبر,2018-02-07,7899,7904,6.329915178335243e-4,5
دالبر,2018-02-10,7892,7899,8.869741509266378e-4,7
دالبر,2018-02-12,7891,7892,1.267266505985646e-4,1
دالبر,2018-02-13,7879,7891,0.0015230359180704357,12
دالبر,2018-02-14,7880,7879,1.2690355328338787e-4,1
دالبر,2018-02-17,7876,7880,5.07872016187421e-4,4
دالبر,2018-02-18,7873,7876,3.810491552926395e-4,3
دالبر,2018-02-19,7868,7873,6.354855108495823e-4,5
دالبر,2018-02-21,7852,7868,0.002037697401676299,16
دالبر,2018-02-24,7858,7852,7.635530668409833e-4,6
دالبر,2018-02-25,7855,7858,3.8192234240841215e-4,3
دالبر,2018-02-26,7845,7855,0.001274697259238407,10
دالبر,2018-02-27,7841,7845,5.101390128159496e-4,4
دالبر,2018-02-28,7881,7841,0.005075498032600495,40
دالبر,2018-03-03,7877,7881,5.078075408775158e-4,4
دالبر,2018-03-04,7881,7877,5.075498032600494e-4,4
دالبر,2018-03-05,7883,7881,0.00025371051626871613,2
دالبر,2018-03-06,7921,7883,0.0047973740683250376,38
دالبر,2018-03-07,7925,7921,5.047318611350496e-4,4
دالبر,2018-03-10,7926,7925,1.2616704515188405e-4,1
دالبر,2018-03-11,7927,7926,1.261511290366909e-4,1
دالبر,2018-03-12,7921,7927,7.574801160513218e-4,6
دالبر,2018-03-13,7905,7921,0.002024035420363816,16
دالبر,2018-03-14,8209,7905,0.03703252527262364,304
دالبر,2018-03-17,8463,8209,0.03001299775138686,254
دالبر,2018-03-18,8485,8463,0.002592810842357948,22
دالبر,2018-03-19,8469,8485,0.0018892431217511815,16
دالبر,2018-03-25,8466,8469,3.543586108723885e-4,3
دالبر,2018-03-26,8462,8466,4.7270148895382866e-4,4
دالبر,2018-03-27,8280,8462,0.021980676325847742,182
دالبر,2018-03-28,8211,8280,0.008403361343514387,69
دالبر,2018-04-03,8198,8211,0.001585752622397444,13
دالبر,2018-04-04,8194,8198,4.8816206974760043e-4,4
دالبر,2018-04-07,8185,8194,0.0010995723883812374,9
دالبر,2018-04-08,8160,8185,0.0030637254898206218,25
دالبر,2018-04-09,8049,8160,0.01379053298375071,111
دالبر,2018-04-10,8039,8049,0.0012439358127573161,10
دالبر,2018-04-11,8034,8039,6.223549912095649e-4,5
دالبر,2018-04-15,8030,8034,4.981320049192862e-4,4
دالبر,2018-04-16,8011,8030,0.00237173885877272,19
دالبر,2018-04-17,7997,8011,0.0017506564959671555,14
دالبر,2018-04-18,7957,7997,0.005027020233124667,40
دالبر,2018-04-21,7943,7957,0.0017625582271481104,14
دالبر,2018-04-22,7932,7943,0.0013867876952361588,11
دالبر,2018-04-23,7897,7932,0.004432062808100283,35
دالبر,2018-04-24,7857,7897,0.00509100165392758,40
دالبر,2018-04-25,7683,7857,0.022647403355115527,174
دالبر,2018-04-28,7605,7683,0.010256410255061615,78
دالبر,2018-04-29,7439,7605,0.02231482725872902,166
دالبر,2018-04-30,7220,7439,0.030332409968098002,219
دالبر,2018-05-01,7216,7220,5.543237249786136e-4,4
دالبر,2018-05-05,7160,7216,0.007821229049186978,56
دالبر,2018-05-06,6941,7160,0.03155164961366494,219
دالبر,2018-05-12,5870,6941,0.18245315158731631,1071
دالبر,2018-05-13,6001,5870,0.021829695047187184,131
دالبر,2018-05-14,6004,6001,4.996668886576171e-4,3
دالبر,2018-05-15,6006,6004,3.3300033294488836e-4,2
دالبر,2018-05-16,6005,6006,1.6652789339441666e-4,1
دالبر,2018-05-19,5987,6005,0.003006514113411305,18
دالبر,2018-05-20,5985,5987,3.341687551655524e-4,2
دالبر,2018-05-21,5986,5985,1.6705646505729092e-4,1
دالبر,2018-05-22,5989,5986,5.009183502252599e-4,3
دالبر,2018-05-23,5985,5989,6.683375103311048e-4,4
دالبر,2018-05-26,5989,5985,6.678911336336799e-4,4
دالبر,2018-05-27,5983,5989,0.0010028413837534947,6
دالبر,2018-05-28,5981,5983,3.3439224204407416e-4,2
دالبر,2018-05-29,6010,5981,0.004825291180561515,29
دالبر,2018-05-30,6013,6010,4.989190087312624e-4,3
دالبر,2018-06-02,6013,6013,0,0
دالبر,2018-06-03,6011,6013,3.3272334048698663e-4,2
دالبر,2018-06-09,6005,6011,9.991673603665e-4,6
دالبر,2018-06-10,6002,6005,4.998333887870987e-4,3
دالبر,2018-06-11,5981,6002,0.003511118541462779,21
دالبر,2018-06-12,5887,5981,0.01596738576253314,94
دالبر,2018-06-13,5929,5887,0.0070838252644486715,42
دالبر,2018-06-17,5984,5929,0.009191176469052277,55
دالبر,2018-06-18,6035,5984,0.00845070422395183,51
دالبر,2018-06-19,6030,6035,8.29187396214065e-4,5
دالبر,2018-06-20,6070,6030,0.006589785830874829,40
دالبر,2018-06-23,6111,6070,0.006709212893682014,41
دالبر,2018-06-24,6109,6111,3.2738582414022164e-4,2
دالبر,2018-06-25,6054,6109,0.009084902542272066,55
دالبر,2018-06-26,6239,6054,0.029652187845864368,185
دالبر,2018-06-27,6447,6239,0.03226306808868263,208
دالبر,2018-06-30,6472,6447,0.0038627935717146485,25
دالبر,2018-07-01,6584,6472,0.017010935598874403,112
دالبر,2018-07-02,6578,6584,9.121313467752916e-4,6
دالبر,2018-07-03,6648,6578,0.010529482549559344,70
دالبر,2018-07-04,6634,6648,0.0021103406689613594,14
دالبر,2018-07-07,6650,6634,0.002406015037232178,16
دالبر,2018-07-08,6650,6650,0,0
دالبر,2018-07-10,6648,6650,3.008423585588384e-4,2
دالبر,2018-07-11,6619,6648,0.004381326483701264,29
دالبر,2018-07-14,6614,6619,7.559721801094689e-4,5
دالبر,2018-07-15,6576,6614,0.005778588806907149,38
دالبر,2018-07-16,6572,6576,6.086427266268041e-4,4
دالبر,2018-07-17,6486,6572,0.013259327780872751,86
دالبر,2018-07-18,6459,6486,0.004180213654717415,27
دالبر,2018-07-21,6469,6459,0.0015458339771918636,10
دالبر,2018-07-22,6431,6469,0.0059088788670643945,38
دالبر,2018-07-23,6363,6431,0.010686782962331167,68
دالبر,2018-07-24,6352,6363,0.0017317380349918547,11
دالبر,2018-07-25,6300,6352,0.0082539682526581,52
دالبر,2018-07-28,6279,6300,0.003344481604818525,21
دالبر,2018-07-29,6257,6279,0.0035160620099862453,22
دالبر,2018-07-30,6188,6257,0.011150614089988587,69
دالبر,2018-07-31,6141,6188,0.00765347663122399,47
دالبر,2018-08-01,6127,6141,0.0022849681732846467,14
دالبر,2018-08-04,6103,6127,0.003932492216298133,24
دالبر,2018-08-05,6029,6103,0.01227400895467341,74
دالبر,2018-08-06,6020,6029,0.0014950166110473393,9
دالبر,2018-08-07,5947,6020,0.012275096685341332,73
دالبر,2018-08-08,5860,5947,0.01484641637971904,87
دالبر,2018-08-11,5870,5860,0.0017035775124866136,10
دالبر,2018-08-12,5870,5870,0,0
دالبر,2018-08-13,5869,5870,1.703867779569966e-4,1
دالبر,2018-08-14,5863,5869,0.0010233668768508668,6
دالبر,2018-08-15,5865,5863,3.410059675462905e-4,2
دالبر,2018-08-18,5867,5865,3.4088972211677353e-4,2
دالبر,2018-08-19,5894,5867,0.0045809297582998084,27
دالبر,2018-08-20,5907,5894,0.002200778736719015,13
دالبر,2018-08-21,5928,5907,0.0035425101208599002,21
دالبر,2018-08-25,6048,5928,0.019841269837989207,120
دالبر,2018-08-26,6147,6048,0.016105417274100305,99
دالبر,2018-08-27,6270,6147,0.01961722487725403,123
دالبر,2018-08-28,6559,6270,0.04406159474858033,289
دالبر,2018-08-29,6593,6559,0.005156984679939787,34
دالبر,2018-09-01,6861,6593,0.03906136131189894,268
دالبر,2018-09-02,6890,6861,0.004208998548010305,29
دالبر,2018-09-03,6767,6890,0.01817644450743661,123
دالبر,2018-09-04,6657,6767,0.01652395973914316,110
دالبر,2018-09-05,6706,6657,0.007306889351728766,49
دالبر,2018-09-16,4045,6706,0.6578491963763043,2661
دالبر,2018-09-17,4247,4045,0.04756298562572098,202
دالبر,2018-09-18,4459,4247,0.04754429243158908,212
دالبر,2018-09-22,4573,4459,0.02492893067462739,114
دالبر,2018-09-23,4801,4573,0.04749010621797748,228
دالبر,2018-09-24,5041,4801,0.047609601260144886,240
دالبر,2018-09-25,5429,5041,0.07146804198352034,388
دالبر,2018-09-26,5692,5429,0.046205200272978704,263
دالبر,2018-09-29,5976,5692,0.04752342703354695,284
دالبر,2018-09-30,6087,5976,0.018235584028546806,111
دالبر,2018-10-03,5529,6087,0.10092240909731914,558
دالبر,2018-10-06,5453,5529,0.013937282227409264,76
دالبر,2018-10-07,5331,5453,0.022885012188541547,122
دالبر,2018-10-08,5191,5331,0.026969755340595307,140
دالبر,2018-10-09,4975,5191,0.04341708541840862,216
دالبر,2018-10-10,4732,4975,0.05135249364933379,243
دالبر,2018-10-13,4496,4732,0.0524911031911719,236
دالبر,2018-10-14,4273,4496,0.05218815819045444,223
دالبر,2018-10-15,4452,4273,0.04020664868818359,179
دالبر,2018-10-16,4673,4452,0.047292959544769315,221
دالبر,2018-10-17,4622,4673,0.011034184333398055,51
دالبر,2018-10-20,4833,4622,0.04365818331395444,211
دالبر,2018-10-21,4817,4833,0.003321569440871586,16
دالبر,2018-10-22,4637,4817,0.038818201414962644,180
دالبر,2018-10-23,4533,4637,0.022942863440780305,104
دالبر,2018-10-24,4328,4533,0.047365988898482904,205
دالبر,2018-10-27,4137,4328,0.04616872128446489,191
دالبر,2018-10-28,4150,4137,0.0031325301197271008,13
دالبر,2018-10-29,4353,4150,0.04663450492840925,203
دالبر,2018-10-31,4436,4353,0.018710550040867774,83
دالبر,2018-11-03,4429,4436,0.0015804922100743977,7
دالبر,2018-11-04,4320,4429,0.02523148147564086,109
دالبر,2018-11-05,4326,4320,0.0013869625516904848,6
دالبر,2018-11-06,4307,4326,0.004411423263428971,19
دالبر,2018-11-10,4255,4307,0.012220916565870524,52
دالبر,2018-11-11,4209,4255,0.01092896174603731,46
دالبر,2018-11-12,4291,4209,0.0191097646191774,82
دالبر,2018-11-13,4293,4291,4.658746796026381e-4,2
دالبر,2018-11-14,4212,4293,0.01923076922620352,81
دالبر,2018-11-17,4210,4212,4.750593823099621e-4,2
دالبر,2018-11-18,4186,4210,0.0057333970363752035,24
دالبر,2018-11-19,4205,4186,0.0045184304388779,19
دالبر,2018-11-20,4229,4205,0.005675100495229344,24
دالبر,2018-11-21,4243,4229,0.003299552202851861,14
دالبر,2018-11-24,4247,4243,9.418412995192274e-4,4
دالبر,2018-11-26,4204,4247,0.010228353946187355,43
دالبر,2018-11-27,4207,4204,7.130972187513436e-4,3
دالبر,2018-11-28,4205,4207,4.7562425672398946e-4,2
دالبر,2018-12-01,4247,4205,0.009889333644951887,42
دالبر,2018-12-02,4293,4247,0.010715117630860676,46
دالبر,2018-12-03,4297,4293,9.308820104885077e-4,4
دالبر,2018-12-04,4261,4297,0.008448720955538905,36
دالبر,2018-12-05,4331,4261,0.01616254906114926,70
دالبر,2018-12-08,4462,4331,0.029359031817714244,131
دالبر,2018-12-09,4524,4462,0.013704686115449892,62
دالبر,2018-12-10,4512,4524,0.0026595744674956616,12
دالبر,2018-12-11,4493,4512,0.004228800355168306,19
دالبر,2018-12-12,4436,4493,0.012849413883487508,57
دالبر,2018-12-15,4319,4436,0.02708960406874517,117
دالبر,2018-12-16,4290,4319,0.006759906758331023,29
دالبر,2018-12-17,4285,4290,0.0011668611432516076,5
دالبر,2018-12-18,4254,4285,0.007287259048592557,31
دالبر,2018-12-19,4193,4254,0.014548056280813723,61
دالبر,2018-12-22,4188,4193,0.001193887296754086,5
دالبر,2018-12-23,4185,4188,7.168458779649113e-4,3
دالبر,2018-12-24,4257,4185,0.016913319234927573,72
دالبر,2018-12-25,4409,4257,0.034474937619760726,152
دالبر,2018-12-26,4416,4409,0.001585144927177277,7
دالبر,2018-12-29,4394,4416,0.005006827490895123,22
دالبر,2018-12-30,4376,4394,0.004113345520083788,18
دالبر,2018-12-31,4398,4376,0.005002273759662966,22
دالبر,2019-01-01,4466,4398,0.01522615315377829,68
دالبر,2019-01-02,4456,4466,0.002244165170052925,10
دالبر,2019-01-05,4610,4456,0.03340563990598576,154
دالبر,2019-01-06,4643,4610,0.0071074736146656305,33
دالبر,2019-01-07,4590,4643,0.011546840956090012,53
دالبر,2019-01-08,4608,4590,0.003906249999152289,18
دالبر,2019-01-09,4605,4608,6.514657979041333e-4,3
دالبر,2019-01-12,4677,4605,0.015394483640069598,72
دالبر,2019-01-13,4691,4677,0.002984438285443522,14
دالبر,2019-01-14,4755,4691,0.013459516295802413,64
دالبر,2019-01-15,4783,4755,0.005854066484245439,28
دالبر,2019-01-20,4821,4783,0.00788218211825717,38
دالبر,2019-01-21,4632,4821,0.040803108799481194,189
دالبر,2019-01-22,4656,4632,0.005154639174150636,24
دالبر,2019-01-23,4665,4656,0.001929260449747211,9
دالبر,2019-01-26,4676,4665,0.0023524379806774084,11
دالبر,2019-01-27,4646,4676,0.006457167454486188,30
دالبر,2019-01-28,4636,4646,0.0021570319236071975,10
دالبر,2019-01-29,4642,4636,0.0012925463159645526,6
دالبر,2019-01-30,4642,4642,0,0
دالبر,2019-02-02,4630,4642,0.0025917926560276904,12
دالبر,2019-02-03,4592,4630,0.008275261322239708,38
دالبر,2019-02-04,4565,4592,0.005914567359054859,27
دالبر,2019-02-05,4552,4565,0.0028558875213409735,13
دالبر,2019-02-06,4544,4552,0.001760563379894242,8
دالبر,2019-02-10,4524,4544,0.004420866488854804,20
دالبر,2019-02-12,4522,4524,4.422821759304993e-4,2
دالبر,2019-02-13,4519,4522,6.638636865094348e-4,3
دالبر,2019-02-16,4494,4519,0.005562972851454612,25
دالبر,2019-02-17,4487,4494,0.0015600624021484147,7
دالبر,2019-02-18,4437,4487,0.011268875363698697,50
دالبر,2019-02-19,4409,4437,0.006350646403640134,28
دالبر,2019-02-20,4386,4409,0.00524395804714,23
دالبر,2019-02-23,4359,4386,0.006194081209866005,27
دالبر,2019-02-24,4356,4359,6.887052340016746e-4,3
دالبر,2019-02-25,4361,4356,0.001146526025877889,5
دالبر,2019-02-26,4367,4361,0.0013739409202257976,6
دالبر,2019-02-27,4373,4367,0.0013720557966219857,6
دالبر,2019-03-02,4379,4373,0.0013701758389198045,6
دالبر,2019-03-03,4384,4379,0.0011405109486449564,5
دالبر,2019-03-04,4385,4384,2.2805017098562137e-4,1
دالبر,2019-03-05,4382,4385,6.846188953252809e-4,3
دالبر,2019-03-06,4346,4382,0.008283479059299706,36
دالبر,2019-03-09,4346,4346,0,0
دالبر,2019-03-10,4351,4346,0.0011491611121238424,5
دالبر,2019-03-11,4400,4351,0.011136363633832644,49
دالبر,2019-03-12,4466,4400,0.014778325119843633,66
دالبر,2019-03-13,4493,4466,0.006009347873133908,27
دالبر,2019-03-16,4499,4493,0.001333629695191458,6
دالبر,2019-03-17,4497,4499,4.447409383044827e-4,2
دالبر,2019-03-18,4606,4497,0.023664785057823535,109
دالبر,2019-03-19,4702,4606,0.020416843891872215,96
دالبر,2019-03-25,4786,4702,0.017551190970006018,84
دالبر,2019-03-26,4862,4786,0.015631427392918257,76
دالبر,2019-03-27,4883,4862,0.004300634854740808,21
دالبر,2019-03-30,4909,4883,0.005296394376594745,26
دالبر,2019-03-31,4882,4909,0.005530520277441516,27
دالبر,2019-04-06,4898,4882,0.003266639444004361,16
دالبر,2019-04-07,4900,4898,4.081632652228238e-4,2
دالبر,2019-04-08,4898,4900,4.0832993050054513e-4,2
دالبر,2019-04-09,4873,4898,0.005130309869663388,25
دالبر,2019-04-10,5113,4873,0.04693917464366532,240
دالبر,2019-04-13,5368,5113,0.047503725773564875,255
دالبر,2019-04-14,5627,5368,0.04602807889709826,259
دالبر,2019-04-15,5625,5627,3.5555555549234566e-4,2
دالبر,2019-04-16,5551,5625,0.013330931361316712,74
دالبر,2019-04-17,5744,5551,0.0336002785456824,193
دالبر,2019-04-20,6031,5744,0.047587464757488394,287
دالبر,2019-04-22,6142,6031,0.018072289153684095,111
دالبر,2019-04-23,6041,6142,0.016719086241231734,101
دالبر,2019-04-24,6328,6041,0.04535398229371776,287
دالبر,2019-04-27,6638,6328,0.0467008134910062,310
دالبر,2019-04-28,6574,6638,0.009735320959882061,64
دالبر,2019-04-29,6715,6574,0.020997766191958634,141
دالبر,2019-04-30,6785,6715,0.010316875459054254,70
دالبر,2019-05-01,6765,6785,0.002956393199858626,20
دالبر,2019-05-04,6791,6765,0.003828596671502194,26
دالبر,2019-05-05,6771,6791,0.002953773445140485,20
دالبر,2019-05-06,6489,6771,0.043458159956317126,282
دالبر,2019-05-07,6173,6489,0.051190669034312214,316
دالبر,2019-05-08,6467,6173,0.04546157413863281,294
دالبر,2019-05-11,6755,6467,0.04263508511582012,288
دالبر,2019-05-12,6776,6755,0.003099173553261633,21
دالبر,2019-05-13,7064,6776,0.04077010191948328,288
دالبر,2019-05-14,7282,7064,0.029936830536949073,218
دالبر,2019-05-15,7322,7282,0.005462988253829146,40
دالبر,2019-05-18,7262,7322,0.008262186724282266,60
دالبر,2019-05-19,7091,7262,0.02411507544434987,171
دالبر,2019-05-20,6786,7091,0.04494547597333547,305
دالبر,2019-05-21,6705,6786,0.012080536910949957,81
دالبر,2019-05-22,6699,6705,8.956560679361611e-4,6
دالبر,2019-05-25,6869,6699,0.024748871739008752,170
دالبر,2019-05-26,7114,6869,0.03443913409693012,245
دالبر,2019-05-28,7326,7114,0.02893802893407889,212
دالبر,2019-06-03,7361,7326,0.004754788750882382,35
دالبر,2019-06-08,7570,7361,0.027608982823301324,209
دالبر,2019-06-09,7918,7570,0.043950492543072685,348
دالبر,2019-06-10,7807,7918,0.014218009476851798,111
دالبر,2019-06-11,7434,7807,0.05017487220202113,373
دالبر,2019-06-12,7351,7434,0.01129098081740022,83
دالبر,2019-06-15,7129,7351,0.031140412395687975,222
دالبر,2019-06-16,7244,7129,0.01587520706572678,115
دالبر,2019-06-17,7170,7244,0.010320781030638663,74
دالبر,2019-06-18,7195,7170,0.003474635162824929,25
دالبر,2019-06-19,7191,7195,5.562508690646293e-4,4
دالبر,2019-06-22,6867,7191,0.047182175615671736,324
دالبر,2019-06-23,6908,6867,0.005935147654033707,41
دالبر,2019-06-24,7000,6908,0.013142857140979592,92
دالبر,2019-06-25,6952,7000,0.006904487916152979,48
دالبر,2019-06-26,6878,6952,0.010758941551212715,74
دالبر,2019-06-30,6741,6878,0.02032339415215496,137
دالبر,2019-07-01,6617,6741,0.01873961009237727,124
دالبر,2019-07-02,6816,6617,0.029196009385387908,199
دالبر,2019-07-03,6968,6816,0.021814006885503154,152
دالبر,2019-07-06,7011,6968,0.006133219226054311,43
دالبر,2019-07-07,7078,7011,0.009465950832231429,67
دالبر,2019-07-08,7341,7078,0.03582618171423155,263
دالبر,2019-07-09,7464,7341,0.01647909967624878,123
دالبر,2019-07-10,7244,7464,0.03036996134312949,220
دالبر,2019-07-13,7165,7244,0.011025819956590953,79
دالبر,2019-07-14,7170,7165,6.973500696377475e-4,5
دالبر,2019-07-15,6979,7170,0.027367817735009625,191
دالبر,2019-07-16,6648,6979,0.049789410341487754,331
دالبر,2019-07-17,6682,6648,0.005088296916329198,34
دالبر,2019-07-20,6445,6682,0.036772692003603925,237
دالبر,2019-07-21,6432,6445,0.0020211442782927325,13
دالبر,2019-07-22,6349,6432,0.013072924867999224,83
دالبر,2019-07-23,6250,6349,0.0158399999974656,99
دالبر,2019-07-24,6298,6250,0.00762146713121285,48
دالبر,2019-07-27,6444,6298,0.022656734943721796,146
دالبر,2019-07-28,6482,6444,0.005862388150900588,38
دالبر,2019-07-29,6466,6482,0.0024744819049683756,16
دالبر,2019-07-30,6476,6466,0.0015441630633810741,10
دالبر,2019-07-31,6378,6476,0.015365318279183863,98
دالبر,2019-08-03,6448,6378,0.010856079402782865,70
دالبر,2019-08-04,6765,6448,0.04685883221775922,317
دالبر,2019-08-05,7014,6765,0.03550042771093521,249
دالبر,2019-08-06,7279,7014,0.03640609973397361,265
دالبر,2019-08-07,7112,7279,0.02348143981672083,167
دالبر,2019-08-10,7067,7112,0.006367624167770252,45
دالبر,2019-08-11,7024,7067,0.00612186788067741,43
دالبر,2019-08-13,7100,7024,0.010704225350605038,76
دالبر,2019-08-14,7170,7100,0.009762900974928466,70
دالبر,2019-08-17,7197,7170,0.003751563150791779,27
دالبر,2019-08-18,7107,7197,0.012663571125275984,90
دالبر,2019-08-19,7229,7107,0.016876469772184745,122
دالبر,2019-08-21,7476,7229,0.03303905831553784,247
دالبر,2019-08-24,7842,7476,0.046671767400322396,366
دالبر,2019-08-25,7835,7842,8.934269303263016e-4,7
دالبر,2019-08-26,8217,7835,0.04648898624236473,382
دالبر,2019-08-27,8625,8217,0.047304347820602395,408
دالبر,2019-08-28,8936,8625,0.03480304386360754,311
دالبر,2019-08-31,9040,8936,0.011504424777488448,104
دالبر,2019-09-01,8883,9040,0.0176742091615812,157
دالبر,2019-09-02,8853,8883,0.0033886818023959467,30
دالبر,2019-09-03,9127,8853,0.03002081735181102,274
دالبر,2019-09-04,9343,9127,0.023118912552379436,216
دالبر,2019-09-07,9514,9343,0.017973512716210477,171
دالبر,2019-09-08,9755,9514,0.024705279341393615,241
دالبر,2019-09-11,10220,9755,0.045499021521966825,465
دالبر,2019-09-14,10731,10220,0.0476190476146101,511
دالبر,2019-09-15,10504,10731,0.021610814925589222,227
دالبر,2019-09-16,10449,10504,0.0052636615939072005,55
دالبر,2019-09-17,10776,10449,0.030345211578475757,327
دالبر,2019-09-18,11193,10776,0.03725542749600148,417
دالبر,2019-09-21,11697,11193,0.04308797127100214,504
دالبر,2019-09-22,12247,11697,0.04490895729199731,550
دالبر,2019-09-23,12859,12247,0.04759312543373566,612
دالبر,2019-09-24,13501,12859,0.047552033179205096,642
دالبر,2019-09-29,14835,13501,0.08992248061409353,1334
دالبر,2019-09-30,15467,14835,0.04086118833381643,632
دالبر,2019-10-01,16224,15467,0.046659270214086584,757
دالبر,2019-10-02,16801,16224,0.03434319385546437,577
دالبر,2019-10-05,16971,16801,0.01001708797301178,170
دالبر,2019-10-06,16123,16971,0.05259567077760989,848
دالبر,2019-10-07,15317,16123,0.052621270480340716,806
دالبر,2019-10-08,15027,15317,0.01929859585949966,290
دالبر,2019-10-09,14686,15027,0.023219392617239588,341
دالبر,2019-10-12,14067,14686,0.04400369659173927,619
دالبر,2019-10-13,13407,14067,0.04922801521226016,660
دالبر,2019-10-14,13233,13407,0.013148945816281345,174
دالبر,2019-10-15,13097,13233,0.010384057416936394,136
دالبر,2019-10-16,12829,13097,0.020890170705363614,268
دالبر,2019-10-20,12745,12829,0.006590819928866942,84
دالبر,2019-10-21,12108,12745,0.052609844726411475,637
دالبر,2019-10-22,12222,12108,0.00932744231636987,114
دالبر,2019-10-23,11685,12222,0.04595635429645217,537
دالبر,2019-10-26,11471,11685,0.018655740561532932,214
دالبر,2019-10-28,11119,11471,0.03165752315571027,352
دالبر,2019-10-30,11670,11119,0.047215081401266915,551
دالبر,2019-11-02,12145,11670,0.039110745159398046,475
دالبر,2019-11-03,12666,12145,0.04113374387800933,521
دالبر,2019-11-04,12629,12666,0.0029297648267535225,37
دالبر,2019-11-05,12141,12629,0.04019438266698012,488
دالبر,2019-11-09,11818,12141,0.027331189708298256,323
دالبر,2019-11-10,11248,11818,0.050675675671170366,570
دالبر,2019-11-11,11641,11248,0.033759986252576236,393
دالبر,2019-11-12,12198,11641,0.045663223475515394,557
دالبر,2019-11-13,12025,12198,0.014386694385497988,173
دالبر,2019-11-16,12226,12025,0.01644037297428101,201
دالبر,2019-11-17,11883,12226,0.028864764787607106,343
دالبر,2019-11-18,11585,11883,0.025722917563597503,298
دالبر,2019-11-19,11725,11585,0.011940298506444324,140
دالبر,2019-11-20,11657,11725,0.005833404820637093,68
دالبر,2019-11-25,12818,11657,0.09057575284049182,1161
دالبر,2019-11-26,13458,12818,0.047555357404699405,640
دالبر,2019-11-27,14008,13458,0.039263278123981775,550
دالبر,2019-11-30,14464,14008,0.03152654867038671,456
دالبر,2019-12-01,15120,14464,0.04338624338337393,656
دالبر,2019-12-02,14584,15120,0.036752605592652726,536
دالبر,2019-12-03,14031,14584,0.03941272895449984,553
دالبر,2019-12-04,14063,14031,0.002275474649628424,32
دالبر,2019-12-07,13954,14063,0.0078113802488310605,109
دالبر,2019-12-08,13848,13954,0.007654534950342682,106
دالبر,2019-12-09,14486,13848,0.04404252381305795,638
دالبر,2019-12-10,14725,14486,0.016230899829118444,239
دالبر,2019-12-11,14319,14725,0.028353935328699353,406
دالبر,2019-12-14,14090,14319,0.016252661460876318,229
دالبر,2019-12-15,13952,14090,0.009891055045162625,138
دالبر,2019-12-16,14516,13952,0.038853678696689604,564
دالبر,2019-12-17,14644,14516,0.00874078120672352,128
دالبر,2019-12-18,14396,14644,0.017227007500887258,248
دالبر,2019-12-21,14414,14396,0.0012487859025080625,18
دالبر,2019-12-22,14224,14414,0.013357705285900048,190
دالبر,2019-12-23,14232,14224,5.621135468969847e-4,8
دالبر,2019-12-24,14173,14232,0.00416284484553991,59
دالبر,2019-12-25,13958,14173,0.015403352914786977,215
دالبر,2019-12-28,14424,13958,0.03230726566609073,466
دالبر,2019-12-29,14424,14424,0,0
دالبر,2019-12-30,15079,14424,0.04343789375665243,655
دالبر,2019-12-31,15059,15079,0.0013281094361293506,20
دالبر,2020-01-01,14828,15059,0.015578635013786172,231
دالبر,2020-01-04,14087,14828,0.05260168949722427,741
دالبر,2020-01-05,13427,14087,0.04915468831092912,660
دالبر,2020-01-07,12792,13427,0.049640400246275765,635
دالبر,2020-01-08,12537,12792,0.020339794207518563,255
دالبر,2020-01-11,12608,12537,0.005631345177218326,71
دالبر,2020-01-12,12927,12608,0.024677032565585438,319
دالبر,2020-01-13,13488,12927,0.04159252668730779,561
دالبر,2020-01-14,14161,13488,0.04752489230650908,673
دالبر,2020-01-15,14336,14161,0.012207031249148504,175
دالبر,2020-01-18,14811,14336,0.03207075821807638,475
دالبر,2020-01-19,14817,14811,4.0494027128265233e-4,6
دالبر,2020-01-20,14825,14817,5.39629005022622e-4,8
دالبر,2020-01-21,15518,14825,0.04465781672608211,693
دالبر,2020-01-22,16291,15518,0.04744951199757844,773
دالبر,2020-01-25,17105,16291,0.0475884244345169,814
دالبر,2020-01-26,17713,17105,0.034325071979093034,608
دالبر,2020-01-27,17391,17713,0.018515324017105667,322
دالبر,2020-01-28,16773,17391,0.03684492934854558,618
دالبر,2020-02-01,16222,16773,0.03396621871323103,551
دالبر,2020-02-02,16822,16222,0.03566757816932187,600
دالبر,2020-02-03,17451,16822,0.03604377972402477,629
دالبر,2020-02-04,17099,17451,0.020585999180034738,352
دالبر,2020-02-05,17237,17099,0.008006033532052792,138
دالبر,2020-02-08,17029,17237,0.012214457689105968,208
دالبر,2020-02-09,16603,17029,0.025658013610452446,426
دالبر,2020-02-10,16211,16603,0.024181111589403424,392
دالبر,2020-02-12,16949,16211,0.043542391878957906,738
دالبر,2020-02-22,17929,16949,0.054660047963932173,980
دالبر,2020-02-23,18816,17929,0.04714073129001165,887
دالبر,2020-02-24,19248,18816,0.022443890273148175,432
دالبر,2020-02-25,20210,19248,0.0476001979194656,962
دالبر,2020-02-26,20724,20210,0.024802161743640118,514
دالبر,2020-02-29,21612,20724,0.04108828428460631,888
دالبر,2020-03-01,22692,21612,0.04759386567743725,1080
دالبر,2020-03-02,23359,22692,0.028554304549486095,667
دالبر,2020-03-03,24258,23359,0.037059938987671695,899
دالبر,2020-03-04,25248,24258,0.03921102661441655,990
دالبر,2020-03-07,25018,25248,0.009193380765481119,230
دالبر,2020-03-09,24762,25018,0.010338421774883352,256
دالبر,2020-03-10,24195,24762,0.023434593923395967,567
دالبر,2020-03-11,23620,24195,0.024343776459595946,575
دالبر,2020-03-14,22800,23620,0.03596491227912434,820
دالبر,2020-03-15,21661,22800,0.052582983239343385,1139
دالبر,2020-03-16,22234,21661,0.025771341188010645,573
دالبر,2020-03-17,21537,22234,0.03236291033884186,697
دالبر,2020-03-18,22488,21537,0.04228922091594232,951
دالبر,2020-03-24,23559,22488,0.04546033362853006,1071
دالبر,2020-03-25,24509,23559,0.03876127136811942,950
دالبر,2020-03-28,25734,24509,0.04760239371852015,1225
دالبر,2020-03-29,26125,25734,0.014966507176460612,391
دالبر,2020-03-30,25067,26125,0.04220688554505099,1058
دالبر,2020-04-04,25252,25067,0.007326152383679465,185
دالبر,2020-04-05,24025,25252,0.05107180020599077,1227
دالبر,2020-04-06,22880,24025,0.050043706291519066,1145
دالبر,2020-04-07,23737,22880,0.036103972699325776,857
دالبر,2020-04-08,23614,23737,0.0052087744556107065,123
دالبر,2020-04-11,22836,23614,0.03406901383630807,778
دالبر,2020-04-12,23589,22836,0.0319216583987485,753
دالبر,2020-04-13,22870,23589,0.031438565805359045,719
دالبر,2020-04-14,22178,22870,0.031202092161998284,692
دالبر,2020-04-15,23129,22178,0.04111721215611928,951
دالبر,2020-04-18,23609,23129,0.02033122961496331,480
دالبر,2020-04-19,24416,23609,0.03305209698422952,807
دالبر,2020-04-20,24122,24416,0.012188044108606747,294
دالبر,2020-04-21,23738,24122,0.016176594489166037,384
دالبر,2020-04-22,24427,23738,0.028206492814172576,689
دالبر,2020-04-25,25624,24427,0.04671401810620067,1197
دالبر,2020-04-26,26000,25624,0.014461538460982248,376
دالبر,2020-04-27,26247,26000,0.00941059930622888,247
دالبر,2020-04-28,27059,26247,0.030008499943456578,812
دالبر,2020-04-29,27831,27059,0.027738852357883696,772
دالبر,2020-05-02,28755,27831,0.03213354199157943,924
دالبر,2020-05-03,30125,28755,0.045477178421726897,1370
دالبر,2020-05-04,28885,30125,0.04292885580602635,1240
دالبر,2020-05-05,27999,28885,0.03164398728413,886
دالبر,2020-05-06,27848,27999,0.0054222924445050886,151
دالبر,2020-05-09,29218,27848,0.0468889040986074,1370
دالبر,2020-05-10,30352,29218,0.03736162361500522,1134
دالبر,2020-05-11,29044,30352,0.04503511912804589,1308
دالبر,2020-05-12,27961,29044,0.038732520294741515,1083
دالبر,2020-05-13,26693,27961,0.04750309069615618,1268
دالبر,2020-05-16,25431,26693,0.049624474065132144,1262
دالبر,2020-05-17,25645,25431,0.008344706570156181,214
دالبر,2020-05-18,26442,25645,0.030141441644726517,797
دالبر,2020-05-19,27384,26442,0.034399649429068084,942
دالبر,2020-05-20,28713,27384,0.046285654579936414,1329
دالبر,2020-05-23,28106,28713,0.021596812067829048,607
دالبر,2020-05-26,26701,28106,0.052619752067240184,1405
دالبر,2020-05-30,26723,26701,8.232608613994214e-4,22
دالبر,2020-05-31,25495,26723,0.0481663071171537,1228
دالبر,2020-06-01,25560,25495,0.0025430359936407265,65
دالبر,2020-06-02,25904,25560,0.013279802346615202,344
دالبر,2020-06-06,26244,25904,0.01295534217295552,340
دالبر,2020-06-07,27533,26244,0.0468165474141279,1289
دالبر,2020-06-08,27369,27533,0.005992180934415134,164
دالبر,2020-06-09,28049,27369,0.02424328852992109,680
دالبر,2020-06-10,29386,28049,0.045497856120414557,1337
دالبر,2020-06-13,30710,29386,0.04311299250917899,1324
دالبر,2020-06-14,31410,30710,0.022285896210688126,700
دالبر,2020-06-15,31960,31410,0.017209011263541647,550
دالبر,2020-06-24,32200,31960,0.00745341614883685,240
دالبر,2020-06-27,31160,32200,0.03337612323384544,1040
دالبر,2020-06-28,29830,31160,0.04458598725965183,1330
دالبر,2020-06-29,30280,29830,0.014861294583392956,450
دالبر,2020-06-30,31790,30280,0.04749921358768483,1510
دالبر,2020-07-01,33370,31790,0.047347917289561045,1580
دالبر,2020-07-04,34830,33370,0.04191788687792369,1460
دالبر,2020-07-05,36550,34830,0.047058823528124245,1720
دالبر,2020-07-06,38370,36550,0.047432890277627496,1820
دالبر,2020-07-07,39650,38370,0.03228247162591973,1280
دالبر,2020-07-08,38180,39650,0.03850183341963065,1470
دالبر,2020-07-11,36420,38180,0.0483250960997165,1760
دالبر,2020-07-12,36930,36420,0.013809910641380723,510
دالبر,2020-07-13,35500,36930,0.04028169013971038,1430
دالبر,2020-07-14,33770,35500,0.051228901390250846,1730
دالبر,2020-07-15,32200,33770,0.048757763973641066,1570
دالبر,2020-07-18,33730,32200,0.04536021345848324,1530
دالبر,2020-07-19,34610,33730,0.02542617740463952,880
دالبر,2020-07-20,33830,34610,0.02305645876372875,780
دالبر,2020-07-21,32290,33830,0.04769278414222072,1540
دالبر,2020-07-22,30720,32290,0.0511067708316697,1570
دالبر,2020-07-25,30270,30720,0.014866204162046046,450
دالبر,2020-07-26,30480,30270,0.006889763779301517,210
دالبر,2020-07-27,29480,30480,0.03392130257686834,1000
دالبر,2020-07-28,28930,29480,0.019011406843449312,550
دالبر,2020-07-29,29800,28930,0.029194630871503535,870
دالبر,2020-08-01,30480,29800,0.022309711285357293,680
دالبر,2020-08-02,31890,30480,0.044214487298707604,1410
دالبر,2020-08-03,30800,31890,0.035389610388461376,1090
دالبر,2020-08-04,29980,30800,0.027351567710895544,820
دالبر,2020-08-05,30850,29980,0.028200972446411638,870
دالبر,2020-08-09,29980,30850,0.02901934622985259,870
دالبر,2020-08-10,28680,29980,0.04532775453119499,1300
دالبر,2020-08-11,27260,28680,0.0520909757867905,1420
دالبر,2020-08-12,26640,27260,0.023273273272399652,620
دالبر,2020-08-15,25570,26640,0.04184591317787071,1070
دالبر,2020-08-16,25150,25570,0.016699801192178933,420
دالبر,2020-08-17,23930,25150,0.050982030921396485,1220
دالبر,2020-08-18,24640,23930,0.028814935063765628,710
دالبر,2020-08-19,23880,24640,0.031825795643558384,760
دالبر,2020-08-22,23490,23880,0.01660280970555118,390
دالبر,2020-08-23,23230,23490,0.011192423589703297,260
دالبر,2020-08-24,22890,23230,0.014853647880521903,340
دالبر,2020-08-25,23050,22890,0.006941431669980849,160
دالبر,2020-08-26,23740,23050,0.029064869417478312,690
دالبر,2020-08-31,23490,23740,0.010642826734327678,250
دالبر,2020-09-05,22780,23490,0.0311676909556116,710
دالبر,2020-09-06,22420,22780,0.016057091881531798,360
دالبر,2020-09-07,22330,22420,0.00403045230613388,90
دالبر,2020-09-08,22270,22330,0.0026942074538529766,60
دالبر,2020-09-09,21600,22270,0.031018518517082476,670
كاوهح,2019-03-05,1744,1833,0.05103211006248159,89
كاوهح,2019-03-06,1770,1744,0.014689265528424143,26
كاوهح,2019-03-09,1753,1770,0.009697661146778287,17
كاوهح,2019-03-10,1888,1753,0.07150423725026259,135
كاوهح,2019-03-11,2058,1888,0.08260447031943417,170
كاوهح,2019-03-12,2114,2058,0.026490066212634784,56
كاوهح,2019-03-13,2114,2114,0,0
كاوهح,2019-03-16,2116,2114,9.451795836743008e-4,2
كاوهح,2019-03-17,2072,2116,0.021235521225272433,44
كاوهح,2019-03-18,2164,2072,0.04251386319662021,92
كاوهح,2019-03-19,2152,2164,0.005576208175847487,12
كاوهح,2019-03-25,2123,2152,0.013659915207885108,29
كاوهح,2019-03-26,2121,2123,9.429514375563643e-4,2
كاوهح,2019-03-27,2071,2121,0.02414292611098845,50
كاوهح,2019-03-30,2130,2071,0.027699530503427452,59
كاوهح,2019-03-31,2070,2130,0.028985507232374152,60
كاوهح,2019-04-06,2007,2070,0.03139013451350765,63
كاوهح,2019-04-07,2034,2007,0.013274336276659618,27
كاوهح,2019-04-08,2051,2034,0.008288639683915827,17
كاوهح,2019-04-09,2184,2051,0.06089743586955246,133
كاوهح,2019-04-10,2330,2184,0.06266094417911548,146
كاوهح,2019-04-13,2274,2330,0.024626209311949778,56
كاوهح,2019-04-14,2253,2274,0.009320905455250375,21
كاوهح,2019-04-15,2311,2253,0.02509736043916168,58
كاوهح,2019-04-16,2356,2311,0.019100169771179894,45
كاوهح,2019-04-17,2311,2356,0.019472089995901304,45
كاوهح,2019-04-20,2343,2311,0.013657703792719718,32
كاوهح,2019-04-22,2305,2343,0.016485900209767507,38
كاوهح,2019-04-23,2285,2305,0.008752735225928782,20
كاوهح,2019-04-24,2302,2285,0.007384882707478331,17
كاوهح,2019-04-27,2292,2302,0.00436300174329712,10
كاوهح,2019-04-28,2487,2292,0.07840772011322569,195
كاوهح,2019-07-14,3301,2487,0.24659194176110513,814
كاوهح,2019-07-15,3627,3301,0.0898814446953732,326
كاوهح,2019-07-16,3268,3627,0.10985312114141582,359
كاوهح,2019-07-17,3100,3268,0.054193548369614986,168
كاوهح,2019-12-01,3168,3100,0.02146464645787101,68
كاوهح,2019-12-02,3344,3168,0.052631578931629314,176
كاوهح,2019-12-03,3419,3344,0.021936238659860708,75
كاوهح,2019-12-04,3535,3419,0.032814710033150014,116
كاوهح,2019-12-07,3657,3535,0.03336067814236788,122
كاوهح,2019-12-08,3563,3657,0.0263822621312427,94
كاوهح,2019-12-09,3577,3563,0.003913894323759046,14
كاوهح,2019-12-10,3638,3577,0.01676745464080059,61
كاوهح,2019-12-11,3616,3638,0.006084070794777636,22
كاوهح,2019-12-14,3680,3616,0.01739130434310019,64
كاوهح,2019-12-15,3715,3680,0.009421265138782971,35
كاوهح,2019-12-16,3701,3715,0.003782761414811467,14
كاوهح,2019-12-17,3793,3701,0.024255206953795096,92
كاوهح,2019-12-18,3824,3793,0.008106694558549505,31
كاوهح,2019-12-21,3885,3824,0.015701415697374155,61
كاوهح,2019-12-22,4027,3885,0.03526198161528136,142
كاوهح,2019-12-23,4078,4027,0.012506130453039204,51
كاوهح,2019-12-24,4017,4078,0.015185461783623237,61
كاوهح,2019-12-25,3958,4017,0.01490651843989224,59
كاوهح,2019-12-28,3957,3958,2.5271670451030664e-4,1
كاوهح,2019-12-29,3874,3957,0.021424883835460793,83
كاوهح,2019-12-30,3849,3874,0.00649519355508049,25
كاوهح,2019-12-31,3950,3849,0.025569620246691235,101
كاوهح,2020-01-01,4103,3950,0.037289787950940824,153
كاوهح,2020-01-04,3716,4103,0.10414424109145742,387
كاوهح,2020-01-05,3806,3716,0.023646873351642967,90
كاوهح,2020-01-07,3694,3806,0.030319436916535075,112
كاوهح,2020-01-08,3631,3694,0.017350592118603528,63
كاوهح,2020-01-11,3703,3631,0.01944369429666657,72
كاوهح,2020-01-12,4053,3703,0.0863557858163445,350
كاوهح,2020-01-13,4418,4053,0.08261656856436926,365
كاوهح,2020-01-14,4348,4418,0.016099356022056265,70
كاوهح,2020-01-15,4345,4348,6.904487915557079e-4,3
كاوهح,2020-01-18,4672,4345,0.06999143834118333,327
كاوهح,2020-01-19,4666,4672,0.0012858979851509006,6
كاوهح,2020-01-20,4536,4666,0.028659611986627066,130
كاوهح,2020-01-21,4325,4536,0.04878612715635002,211
كاوهح,2020-01-22,4359,4325,0.007799954116127562,34
كاوهح,2020-01-25,4413,4359,0.012236573756574535,54
كاوهح,2020-01-26,4381,4413,0.00730426843019761,32
كاوهح,2020-01-27,4355,4381,0.00597014925236047,26
كاوهح,2020-01-28,4355,4355,0,0
كاوهح,2020-03-04,6200,4355,0.2975806451132934,1845
كاوهح,2020-03-07,6137,6200,0.01026560208403689,63
كاوهح,2020-03-09,5589,6137,0.09804974054427451,548
كاوهح,2020-03-10,5094,5589,0.09717314485724908,495
كاوهح,2020-03-11,5106,5094,0.0023501762627594638,12
غبهنوش,2018-01-15,4274,4222,0.012166588672866964,52
غبهنوش,2018-01-16,4391,4274,0.02664541106202564,117
غبهنوش,2018-01-17,4482,4391,0.020303435961556572,91
غبهنوش,2018-01-20,4499,4482,0.003778617469709131,17
غبهنوش,2018-01-21,4448,4499,0.011465827335551746,51
غبهنوش,2018-01-22,4409,4448,0.008845543205070187,39
غبهنوش,2018-01-23,4386,4409,0.00524395804714,23
غبهنوش,2018-01-24,4340,4386,0.01059907833857164,46
غبهنوش,2018-01-27,4330,4340,0.002309468821637536,10
غبهنوش,2018-01-28,4330,4330,0,0
غبهنوش,2018-01-29,4242,4330,0.02074493163113038,88
غبهنوش,2018-01-30,4144,4242,0.023648648642941927,98
غبهنوش,2018-01-31,4318,4144,0.040296433524711336,174
غبهنوش,2018-02-03,4513,4318,0.04320850874291857,195
غبهنوش,2018-02-04,4732,4513,0.04628064242470823,219
غبهنوش,2018-02-05,4968,4732,0.04750402575533332,236
غبهنوش,2018-02-06,4983,4968,0.0030102347977101675,15
غبهنوش,2018-02-07,5047,4983,0.012680800473017475,64
غبهنوش,2018-02-10,5010,5047,0.007385229539444065,37
غبهنوش,2018-02-12,4974,5010,0.007237635704214387,36
غبهنوش,2018-02-13,4900,4974,0.015102040813244481,74
غبهنوش,2018-02-14,4911,4900,0.002239869679853417,11
غبهنوش,2018-02-17,4993,4911,0.016422992185775486,82
غبهنوش,2018-02-18,4994,4993,2.0024028830591904e-4,1
غبهنوش,2018-02-19,4987,4994,0.0014036494883890816,7
غبهنوش,2018-02-21,5058,4987,0.014037168838664063,71
غبهنوش,2018-02-24,5305,5058,0.046559849190092394,247
غبهنوش,2018-02-25,5284,5305,0.003974261922033637,21
غبهنوش,2018-02-26,5130,5284,0.030019493171536158,154
غبهنوش,2018-02-27,5158,5130,0.005428460642607898,28
غبهنوش,2018-02-28,5175,5158,0.0032850241539545844,17
غبهنوش,2018-03-03,5408,5175,0.043084319518660444,233
غبهنوش,2018-03-04,5422,5408,0.0025820730353039332,14
غبهنوش,2018-03-05,5155,5422,0.051794374383745026,267
غبهنوش,2018-03-06,5113,5155,0.008214355562641431,42
غبهنوش,2018-03-07,5069,5113,0.008680213058062691,44
غبهنوش,2018-03-10,4928,5069,0.028612012981206976,141
غبهنوش,2018-03-11,4729,4928,0.04208077816830603,199
غبهنوش,2018-03-12,4651,4729,0.016770586966938165,78
غبهنوش,2018-03-13,4644,4651,0.0015073212744385611,7
غبهنوش,2018-03-14,4559,4644,0.01864443956599157,85
غبهنوش,2018-03-17,4480,4559,0.017633928567492425,79
غبهنوش,2018-03-18,4481,4480,2.2316447216622081e-4,1
غبهنوش,2018-03-19,4374,4481,0.024462734333684788,107
غبهنوش,2018-03-25,4373,4374,2.286759661036643e-4,1
غبهنوش,2018-03-26,4371,4373,4.575611987056597e-4,2
غبهنوش,2018-03-27,4250,4371,0.028470588228595155,121
غبهنوش,2018-03-28,4225,4250,0.005917159761913098,25
غبهنوش,2018-04-03,4221,4225,9.47642738463008e-4,4
غبهنوش,2018-04-04,4193,4221,0.006677796325619414,28
غبهنوش,2018-04-07,4074,4193,0.029209621985957383,119
غبهنوش,2018-04-08,4061,4074,0.0032011819740947597,13
غبهنوش,2018-04-09,3907,4061,0.03941643203495868,154
غبهنوش,2018-04-10,3948,3907,0.010385005063225683,41
غبهنوش,2018-04-11,3979,3948,0.007790902234784895,31
غبهنوش,2018-04-15,4022,3979,0.010691198406093685,43
غبهنوش,2018-04-16,4058,4022,0.008871365202348111,36
غبهنوش,2018-04-17,4183,4058,0.029882859184823602,125
غبهنوش,2018-04-18,4247,4183,0.015069460792307638,64
غبهنوش,2018-04-21,4271,4247,0.005619292904327021,24
غبهنوش,2018-04-22,4254,4271,0.003996238833099144,17
غبهنوش,2018-04-23,4244,4254,0.0023562676714523403,10
غبهنوش,2018-04-24,4233,4244,0.0025986298127572333,11
غبهنوش,2018-04-25,4153,4233,0.0192631832363922,80
غبهنوش,2018-04-28,4139,4153,0.003382459530470534,14
غبهنوش,2018-04-29,4133,4139,0.001451729977872797,6
غبهنوش,2018-04-30,4184,4133,0.01218929254010772,51
غبهنوش,2018-05-01,4149,4184,0.008435767652823386,35
غبهنوش,2018-05-05,4134,4149,0.003628447023795731,15
غبهنوش,2018-05-06,4081,4134,0.012987012983830676,53
غبهنوش,2018-05-07,4170,4081,0.021342925654354212,89
غبهنوش,2018-05-08,4177,4170,0.0016758439067091587,7
غبهنوش,2018-05-09,4135,4177,0.010157194677108296,42
غبهنوش,2018-05-12,4125,4135,0.002424242423654729,10
غبهنوش,2018-05-13,4319,4125,0.04491780503706464,194
غبهنوش,2018-05-14,4325,4319,0.0013872832366734603,6
غبهنوش,2018-05-15,4302,4325,0.005346350533392294,23
غبهنوش,2018-05-16,4379,4302,0.017583923266137492,77
غبهنوش,2018-05-19,4381,4379,4.5651677688735064e-4,2
غبهنوش,2018-05-20,4568,4381,0.040936952705574216,187
غبهنوش,2018-05-21,4454,4568,0.025594970807006068,114
غبهنوش,2018-05-22,4317,4454,0.03173500115086055,137
غبهنوش,2018-05-23,4342,4317,0.00575771533722761,25
غبهنوش,2018-05-26,4317,4342,0.005791058604171633,25
غبهنوش,2018-05-27,4301,4317,0.0037200651002743394,16
غبهنوش,2018-05-28,4301,4301,0,0
غبهنوش,2018-05-29,4228,4301,0.01726584673196172,73
غبهنوش,2018-05-30,4181,4228,0.01124132982271195,47
غبهنوش,2018-06-02,4157,4181,0.005773394273328507,24
غبهنوش,2018-06-03,4154,4157,7.221954740678393e-4,3
غبهنوش,2018-06-09,4149,4154,0.001205109664689055,5
غبهنوش,2018-06-10,4112,4149,0.008998054472519928,37
غبهنوش,2018-06-11,4181,4112,0.016503228888662225,69
غبهنوش,2018-06-12,4262,4181,0.019005161891364343,81
غبهنوش,2018-06-13,4389,4262,0.028935976297804516,127
غبهنوش,2018-06-17,4591,4389,0.043999128720540376,202
غبهنوش,2018-06-18,4627,4591,0.007780419276468463,36
غبهنوش,2018-06-19,4587,4627,0.008720296488179572,40
غبهنوش,2018-06-20,4516,4587,0.015721877764454852,71
غبهنوش,2018-06-23,4427,4516,0.020103907833723986,89
غبهنوش,2018-06-24,4482,4427,0.012271307449292434,55
غبهنوش,2018-06-25,4688,4482,0.04394197951281101,206
غبهنوش,2018-06-26,4730,4688,0.008879492598545561,42
غبهنوش,2018-06-27,4507,4730,0.04947858885079241,223
غبهنوش,2018-06-30,4447,4507,0.013492241957838488,60
غبهنوش,2018-07-01,4461,4447,0.003138309795306364,14
غبهنوش,2018-07-02,4438,4461,0.0051825146450692845,23
غبهنوش,2018-07-03,4419,4438,0.004299615296605654,19
غبهنوش,2018-07-04,4369,4419,0.01144426641990289,50
غبهنوش,2018-07-07,4211,4369,0.03752077890346217,158
غبهنوش,2018-07-08,4209,4211,4.751722498277091e-4,2
غبهنوش,2018-07-10,4193,4209,0.003815883614639665,16
غبهنوش,2018-07-11,4160,4193,0.007932692305785409,33
غبهنوش,2018-07-14,4104,4160,0.0136452241682151,56
غبهنوش,2018-07-15,4153,4104,0.011798699732290223,49
غبهنوش,2018-07-16,4125,4153,0.006787878786233241,28
غبهنوش,2018-07-17,4089,4125,0.00880410858185275,36
غبهنوش,2018-07-24,4126,4089,0.008967523022547861,37
غبهنوش,2018-07-25,4107,4126,0.004626247868364682,19
غبهنوش,2018-07-28,4107,4107,0,0
غبهنوش,2018-07-29,4109,4107,4.867364321034956e-4,2
غبهنوش,2018-07-30,4090,4109,0.004645476771480324,19
غبهنوش,2018-07-31,4168,4090,0.018714011511824852,78
غبهنوش,2018-08-01,4245,4168,0.018138987039307657,77
غبهنوش,2018-08-04,4247,4245,4.709206497596137e-4,2
غبهنوش,2018-08-05,4172,4247,0.01797698944919056,75
غبهنوش,2018-08-06,3990,4172,0.04561403507628721,182
غبهنوش,2018-08-07,3811,3990,0.0469692993841592,179
غبهنوش,2018-08-08,3830,3811,0.004960835507843124,19
غبهنوش,2018-08-11,3835,3830,0.001303780964457945,5
غبهنوش,2018-08-12,3855,3835,0.005188067443530981,20
غبهنوش,2018-08-13,3863,3855,0.002070929329000536,8
غبهنوش,2018-08-14,3884,3863,0.0054067971149828024,21
غبهنوش,2018-08-15,3861,3884,0.005957005955463091,23
غبهنوش,2018-08-18,3902,3861,0.010507432083416856,41
غبهنوش,2018-08-19,4018,3902,0.028870084612028352,116
غبهنوش,2018-08-20,4048,4018,0.007411067191845092,30
غبهنوش,2018-08-21,4076,4048,0.006869479880552139,28
غبهنوش,2018-08-25,4154,4076,0.01877708232576382,78
غبهنوش,2018-08-26,4299,4154,0.0337287741256737,145
غبهنوش,2018-08-27,4470,4299,0.038255033548488804,171
غبهنوش,2018-08-28,4403,4470,0.015216897566382715,67
غبهنوش,2018-08-29,4231,4403,0.04065232804522516,172
غبهنوش,2018-09-01,4288,4231,0.013292910444661167,57
غبهنوش,2018-09-02,4281,4288,0.001635131978127743,7
غبهنوش,2018-09-03,4278,4281,7.012622719258386e-4,3
غبهنوش,2018-09-04,4276,4278,4.677268474116635e-4,2
غبهنوش,2018-09-05,4377,4276,0.023075165633293312,101
غبهنوش,2018-09-08,4425,4377,0.010847457624667241,48
غبهنوش,2018-09-09,4539,4425,0.025115664237692074,114
غبهنوش,2018-09-10,4753,4539,0.045024195235635556,214
غبهنوش,2018-09-11,4886,4753,0.027220630366921687,133
غبهنوش,2018-09-12,5043,4886,0.031132262535964253,157
غبهنوش,2018-09-15,5001,5043,0.008398320334253485,42
غبهنوش,2018-09-16,4766,5001,0.04930759545755191,235
غبهنوش,2018-09-17,4993,4766,0.04546364909964677,227
غبهنوش,2018-09-18,5213,4993,0.04220218683249526,220
غبهنوش,2018-09-22,5296,5213,0.015672205435107212,83
غبهنوش,2018-09-23,5311,5296,0.0028243268682311565,15
غبهنوش,2018-09-24,5435,5311,0.02281508739230633,124
غبهنوش,2018-09-25,5635,5435,0.03549245784640773,200
غبهنوش,2018-09-26,5773,5635,0.0239043824659788,138
غبهنوش,2018-09-29,5887,5773,0.019364701882221044,114
غبهنوش,2018-09-30,5964,5887,0.01291079811990094,77
غبهنوش,2018-10-01,6090,5964,0.020689655169016476,126
غبهنوش,2018-10-02,6325,6090,0.03715415019175428,235
غبهنوش,2018-10-03,6540,6325,0.032874617731976356,215
غبهنوش,2018-10-06,6684,6540,0.02154398563411969,144
غبهنوش,2018-10-07,6360,6684,0.05094339621840512,324
غبهنوش,2018-10-08,6050,6360,0.05123966941301823,310
غبهنوش,2018-10-09,5782,6050,0.04635074367928904,268
غبهنوش,2018-10-10,5794,5782,0.002071108042445442,12
غبهنوش,2018-10-13,5507,5794,0.05211548936769284,287
غبهنوش,2018-10-14,5508,5507,1.8155410308976866e-4,1
غبهنوش,2018-10-15,5568,5508,0.010775862067030196,60
غبهنوش,2018-10-16,5607,5568,0.006955591224013627,39
غبهنوش,2018-10-17,5589,5607,0.003220611915687849,18
غبهنوش,2018-10-20,5577,5589,0.0021516944590009514,12
غبهنوش,2018-10-21,5526,5577,0.009229098803975913,51
غبهنوش,2018-10-22,5315,5526,0.03969896518538119,211
غبهنوش,2018-10-23,5104,5315,0.041340125383749975,211
غبهنوش,2018-10-24,5000,5104,0.02079999999584,104
غبهنوش,2018-10-27,4874,5000,0.025851456703764573,126
غبهنوش,2018-10-28,4825,4874,0.010155440412403016,49
غبهنوش,2018-10-29,4852,4825,0.005564715580056736,27
غبهنوش,2018-10-31,5094,4852,0.04750687081909955,242
غبهنوش,2018-11-03,5100,5094,0.0011764705880046135,6
غبهنوش,2018-11-04,5065,5100,0.006910167816997005,35
غبهنوش,2018-11-05,5026,5065,0.0077596498193872555,39
غبهنوش,2018-11-06,5051,5026,0.004949514946555233,25
غبهنوش,2018-11-10,5047,5051,7.925500295635922e-4,4
غبهنوش,2018-11-11,4962,5047,0.017130189436289762,85
غبهنوش,2018-11-12,4963,4962,2.0149103360840397e-4,1
غبهنوش,2018-11-13,4732,4963,0.04881656803702101,231
غبهنوش,2018-11-14,4614,4732,0.025574338962814403,118
غبهنوش,2018-11-17,4634,4614,0.004315925765145463,20
غبهنوش,2018-11-18,4631,4634,6.478082486184823e-4,3
غبهنوش,2018-11-19,4653,4631,0.0047281323866907084,22
غبهنوش,2018-11-20,4638,4653,0.003234152651307858,15
غبهنوش,2018-11-21,4654,4638,0.0034379028785049624,16
غبهنوش,2018-11-24,4649,4654,0.0010755001073186705,5
غبهنوش,2018-11-26,4630,4649,0.0041036717053771765,19
غبهنوش,2018-11-27,4634,4630,8.631851530290925e-4,4
غبهنوش,2018-11-28,4633,4634,2.1584286634667755e-4,1
غبهنوش,2018-12-01,4630,4633,6.479481640069226e-4,3
غبهنوش,2018-12-02,4631,4630,2.1593608287282743e-4,1
غبهنوش,2018-12-03,4630,4631,2.1598272133564086e-4,1
غبهنوش,2018-12-04,4632,4630,4.3177892909503903e-4,2
غبهنوش,2018-12-05,4635,4632,6.472491907988674e-4,3
غبهنوش,2018-12-08,4643,4635,0.0017230239065856075,8
غبهنوش,2018-12-09,4631,4643,0.002591232994473929,12
غبهنوش,2018-12-10,4537,4631,0.020718536473282225,94
غبهنوش,2018-12-11,4526,4537,0.002430402120541228,11
غبهنوش,2018-12-12,4575,4526,0.010710382511320135,49
غبهنوش,2018-12-15,4570,4575,0.001094091903480505,5
غبهنوش,2018-12-16,4572,4570,4.3744531923940386e-4,2
غبهنوش,2018-12-17,4571,4572,2.1877050968742713e-4,1
غبهنوش,2018-12-18,4569,4571,4.3773254531894666e-4,2
غبهنوش,2018-12-19,4503,4569,0.014656895399809704,66
غبهنوش,2018-12-23,4504,4503,2.2202486673578487e-4,1
غبهنوش,2018-12-24,4505,4504,2.2197558263663137e-4,1
غبهنوش,2018-12-25,4500,4505,0.0011111111108641975,5
غبهنوش,2018-12-26,4499,4500,2.22271615865243e-4,1
غبهنوش,2018-12-29,4476,4499,0.005138516531470394,23
غبهنوش,2018-12-30,4472,4476,8.944543826264636e-4,4
غبهنوش,2018-12-31,4534,4472,0.013674459635272505,62
غبهنوش,2019-01-01,4684,4534,0.03202391118018277,150
غبهنوش,2019-01-02,4904,4684,0.044861337674375744,220
غبهنوش,2019-01-05,4969,4904,0.013081102834960534,65
غبهنوش,2019-01-06,4915,4969,0.010986775175791092,54
غبهنوش,2019-01-07,4847,4915,0.014029296469150134,68
غبهنوش,2019-01-08,4837,4847,0.002067397146564524,10
غبهنوش,2019-01-09,4834,4837,6.206040544847736e-4,3
غبهنوش,2019-01-12,4827,4834,0.0014501760925108398,7
غبهنوش,2019-01-13,5054,4827,0.04491491886725071,227
غبهنوش,2019-01-14,5303,5054,0.046954554017168665,249
غبهنوش,2019-01-15,5565,5303,0.04707996405263612,262
غبهنوش,2019-01-16,5747,5565,0.03166869670581717,182
غبهنوش,2019-01-19,5670,5747,0.01358024691118514,77
غبهنوش,2019-01-20,5510,5670,0.029038112517415948,160
غبهنوش,2019-01-21,5422,5510,0.01623017336476758,88
غبهنوش,2019-01-22,5255,5422,0.03177925784361955,167
غبهنوش,2019-01-23,5236,5255,0.0036287242162664772,19
غبهنوش,2019-01-26,5255,5236,0.0036156041858010266,19
غبهنوش,2019-01-27,5260,5255,9.505703420246063e-4,5
غبهنوش,2019-01-28,5277,5260,0.0032215273823722706,17
غبهنوش,2019-01-29,5277,5277,0,0
غبهنوش,2019-01-30,5299,5277,0.0041517267401110156,22
غبهنوش,2019-02-02,5297,5299,3.7757221061401316e-4,2
غبهنوش,2019-02-03,5286,5297,0.002080968595898417,11
غبهنوش,2019-02-04,5207,5286,0.015171883999390842,79
غبهنوش,2019-02-05,5203,5207,7.687872379840885e-4,4
غبهنوش,2019-02-06,5203,5203,0,0
غبهنوش,2019-02-10,5173,5203,0.005799342740034923,30
غبهنوش,2019-02-12,5153,5173,0.0038812342317327314,20
غبهنوش,2019-02-13,5110,5153,0.008414872796787695,43
غبهنوش,2019-02-16,5103,5110,0.0013717421122140421,7
غبهنوش,2019-02-17,4849,5103,0.0523819344086653,254
غبهنوش,2019-02-18,4928,4849,0.016030844152591144,79
غبهنوش,2019-02-19,4931,4928,6.083958627847503e-4,3
غبهنوش,2019-02-20,4947,4931,0.0032342834034294957,16
غبهنوش,2019-02-23,4935,4947,0.0024316109417565125,12
غبهنوش,2019-02-24,4942,4935,0.001416430594614239,7
غبهنوش,2019-02-25,4942,4942,0,0
غبهنوش,2019-02-26,4931,4942,0.0022307848302107513,11
غبهنوش,2019-02-27,4968,4931,0.007447665054861581,37
غبهنوش,2019-03-02,5178,4968,0.04055619929691846,210
غبهنوش,2019-03-03,5096,5178,0.016091051802179932,82
غبهنوش,2019-03-04,5100,5096,7.84313725336409e-4,4
غبهنوش,2019-03-05,5092,5100,0.001571091908568128,8
غبهنوش,2019-03-06,5025,5092,0.013333333330679932,67
غبهنوش,2019-03-09,5006,5025,0.0037954454646832907,19
غبهنوش,2019-03-10,4979,5006,0.005422775656673473,27
غبهنوش,2019-03-11,4968,4979,0.0022141706919858754,11
غبهنوش,2019-03-12,4922,4968,0.009345794390624584,46
غبهنوش,2019-03-13,5017,4922,0.018935618891980144,95
غبهنوش,2019-03-16,5190,5017,0.03333333332691072,173
غبهنوش,2019-03-17,5180,5190,0.0019305019301292467,10
غبهنوش,2019-03-18,5142,5180,0.00739012057421429,38
غبهنوش,2019-03-19,5128,5142,0.002730109203835782,14
غبهنوش,2019-03-25,5129,5128,1.9496977964613573e-4,1
غبهنوش,2019-03-26,5317,5129,0.035358284740387755,188
غبهنوش,2019-03-27,5421,5317,0.019184652274638506,104
غبهنوش,2019-03-30,5657,5421,0.041718225200332644,236
غبهنوش,2019-03-31,5662,5657,8.83080183524712e-4,5
غبهنوش,2019-04-06,5723,5662,0.010658745411382361,61
غبهنوش,2019-04-07,5983,5723,0.043456459962651434,260
غبهنوش,2019-04-08,6241,5983,0.04133952891502331,258
غبهنوش,2019-04-09,6553,6241,0.04761178085646089,312
غبهنوش,2019-04-10,6880,6553,0.04752906976053356,327
غبهنوش,2019-04-13,7211,6880,0.04590209401665482,331
غبهنوش,2019-04-14,7552,7211,0.04515360168893623,341
غبهنوش,2019-04-15,7823,7552,0.034641441897655445,271
غبهنوش,2019-04-20,7904,7823,0.010247975707205469,81
غبهنوش,2019-04-22,7532,7904,0.04938927243104231,372
غبهنوش,2019-04-23,7542,7532,0.001325908246973494,10
غبهنوش,2019-04-24,7411,7542,0.017676426930552363,131
غبهنوش,2019-04-27,7756,7411,0.04448169158786982,345
غبهنوش,2019-04-28,7910,7756,0.019469026546211247,154
غبهنوش,2019-04-29,8082,7910,0.021281860922880244,172
غبهنوش,2019-04-30,7919,8082,0.020583406993233563,163
غبهنوش,2019-05-01,7993,7919,0.009258100837075178,74
غبهنوش,2019-05-04,7943,7993,0.006294850811243252,50
غبهنوش,2019-05-05,7934,7943,0.0011343584571295237,9
غبهنوش,2019-05-06,7812,7934,0.015616999485968125,122
غبهنوش,2019-05-07,7686,7812,0.016393442620817923,126
غبهنوش,2019-05-08,8036,7686,0.04355400696322125,350
غبهنوش,2019-05-11,8436,8036,0.04741583688390044,400
غبهنوش,2019-05-12,8846,8436,0.04634863214488485,410
غبهنوش,2019-05-13,9037,8846,0.021135332519515843,191
غبهنوش,2019-05-14,9238,9037,0.02175795626523512,201
غبهنوش,2019-05-15,9699,9238,0.04753067326038451,461
غبهنوش,2019-05-18,10183,9699,0.047530197383135596,484
غبهنوش,2019-05-19,10596,10183,0.038976972438752644,413
غبهنوش,2019-05-20,10196,10596,0.039231071004390834,400
غبهنوش,2019-05-21,9701,10196,0.05102566745170336,495
غبهنوش,2019-05-22,9557,9701,0.01506748979647719,144
غبهنوش,2019-05-25,9870,9557,0.03171225936862084,313
غبهنوش,2019-05-26,10266,9870,0.038573933368539454,396
غبهنوش,2019-05-28,10769,10266,0.046708143741600136,503
غبهنوش,2019-05-29,10709,10769,0.005602764029731743,60
غبهنوش,2019-06-01,10359,10709,0.033787045078309964,350
غبهنوش,2019-06-02,10653,10359,0.02759785975522408,294
غبهنوش,2019-06-03,11183,10653,0.04739336492467197,530
غبهنوش,2019-06-08,11233,11183,0.004451170657486765,50
غبهنوش,2019-06-09,11384,11233,0.013264230497780725,151
غبهنوش,2019-06-10,11953,11384,0.04760311218542599,569
غبهنوش,2019-06-11,12539,11953,0.0467341893255655,586
غبهنوش,2019-06-12,13165,12539,0.04755032282206226,626
غبهنوش,2019-06-15,13823,13165,0.047601823045098614,658
غبهنوش,2019-06-16,14321,13823,0.03477410795092702,498
غبهنوش,2019-06-17,13605,14321,0.052627710396719755,716
غبهنوش,2019-06-18,12925,13605,0.05261121856459487,680
غبهنوش,2019-06-19,12870,12925,0.004273504273172222,55
غبهنوش,2019-06-22,12808,12870,0.004840724546780081,62
غبهنوش,2019-06-23,12377,12808,0.03482265492164315,431
غبهنوش,2019-06-24,11885,12377,0.04139671854931454,492
غبهنوش,2019-06-25,12277,11885,0.03192962449849885,392
غبهنوش,2019-06-26,12456,12277,0.01437058445613595,179
غبهنوش,2019-06-30,11947,12456,0.042604838031086896,509
غبهنوش,2019-07-01,11414,11947,0.046697038720282365,533
غبهنوش,2019-07-02,11866,11414,0.03809202763879217,452
غبهنوش,2019-07-03,11793,11866,0.006190112778242168,73
غبهنوش,2019-07-06,11709,11793,0.00717396874138065,84
غبهنوش,2019-07-07,11499,11709,0.01826245760342095,210
غبهنوش,2019-07-08,11912,11499,0.03467092007768041,413
غبهنوش,2019-07-09,12370,11912,0.037025060627564665,458
غبهنوش,2019-07-10,12988,12370,0.04758238373517228,618
غبهنوش,2019-07-13,13576,12988,0.04331172657312082,588
غبهنوش,2019-07-14,13529,13576,0.003474018774227658,47
غبهنوش,2019-07-15,13044,13529,0.03718184605664046,485
غبهنوش,2019-07-16,12719,13044,0.025552323293847604,325
غبهنوش,2019-07-23,12170,12719,0.0451109285090295,549
غبهنوش,2019-07-24,12169,12170,8.217602103030848e-5,1
غبهنوش,2019-07-27,12109,12169,0.004954992154186556,60
غبهنوش,2019-07-28,12410,12109,0.02425463335823895,301
غبهنوش,2019-07-29,12385,12410,0.0020185708516739145,25
غبهنوش,2019-07-30,12428,12385,0.003459929191868367,43
غبهنوش,2019-07-31,12372,12428,0.00452634982181326,56
غبهنوش,2019-08-03,12231,12372,0.011528084374823964,141
غبهنوش,2019-08-04,12770,12231,0.04220830070147155,539
غبهنوش,2019-08-05,13407,12770,0.04751249347001473,637
غبهنوش,2019-08-06,13724,13407,0.023098222091001295,317
غبهنوش,2019-08-07,13562,13724,0.01194514083380437,162
غبهنوش,2019-08-10,13761,13562,0.014461158344999551,199
غبهنوش,2019-08-11,13925,13761,0.011777378814235018,164
غبهنوش,2019-08-13,13484,13925,0.03270542865375961,441
غبهنوش,2019-08-14,13031,13484,0.034763256846384524,453
غبهنوش,2019-08-17,12890,13031,0.010938712179135864,141
غبهنوش,2019-08-18,13103,12890,0.016255819276787313,213
غبهنوش,2019-08-19,13758,13103,0.04760866404654683,655
غبهنوش,2019-08-21,14397,13758,0.04438424671498338,639
غبهنوش,2019-08-24,15115,14397,0.04750248097601704,718
غبهنوش,2019-08-25,15736,15115,0.039463650226266925,621
غبهنوش,2019-08-26,16322,15736,0.0359024629312644,586
غبهنوش,2019-08-27,17135,16322,0.047446746422675996,813
غبهنوش,2019-08-28,17622,17135,0.027635909656813305,487
غبهنوش,2019-08-31,18338,17622,0.03904460682522387,716
غبهنوش,2019-09-01,17758,18338,0.03266133573416706,580
غبهنوش,2019-09-02,16952,17758,0.047546012267133904,806
غبهنوش,2019-09-03,16105,16952,0.05259236261703866,847
غبهنوش,2019-09-04,16909,16105,0.047548642731826324,804
غبهنوش,2019-09-07,17754,16909,0.04759490818702293,845
غبهنوش,2019-09-08,18073,17754,0.017650639073886424,319
غبهنوش,2019-09-16,19323,18073,0.0646897479653941,1250
غبهنوش,2019-09-17,19754,19323,0.021818365899472593,431
غبهنوش,2019-09-18,20623,19754,0.04213741938407906,869
غبهنوش,2019-09-21,21361,20623,0.034548944336194515,738
غبهنوش,2019-09-22,21989,21361,0.028559734411362055,628
غبهنوش,2019-09-23,22683,21989,0.03059560022789774,694
غبهنوش,2019-09-24,23809,22683,0.04729304044490348,1126
غبهنوش,2019-09-25,24490,23809,0.027807268271628938,681
غبهنوش,2019-09-28,25055,24490,0.02255038914298342,565
غبهنوش,2019-09-29,26295,25055,0.04715725422904897,1240
غبهنوش,2019-09-30,27608,26295,0.0475586786421487,1313
غبهنوش,2019-10-01,26584,27608,0.03851941017008278,1024
غبهنوش,2019-10-02,26839,26584,0.009501099146410034,255
غبهنوش,2019-10-05,26504,26839,0.012639601569097509,335
غبهنوش,2019-10-06,25221,26504,0.05087030648860591,1283
غبهنوش,2019-10-07,24387,25221,0.034198548405535795,834
غبهنوش,2019-10-08,23490,24387,0.03818646232276771,897
غبهنوش,2019-10-09,22774,23490,0.03143936067307283,716
غبهنوش,2019-10-12,22571,22774,0.008993841654822832,203
غبهنوش,2019-10-13,21519,22571,0.048887030064181096,1052
غبهنوش,2019-10-14,21010,21519,0.024226558780379506,509
غبهنوش,2019-10-15,20738,21010,0.013116018901865367,272
غبهنوش,2019-10-16,19703,20738,0.05253007156004009,1035
غبهنوش,2019-10-20,18867,19703,0.044310171196040166,836
غبهنوش,2019-10-21,17984,18867,0.049099199285526064,883
غبهنوش,2019-10-22,18883,17984,0.04760896043808669,899
غبهنوش,2019-10-23,19322,18883,0.022720215297447457,439
غبهنوش,2019-10-26,19896,19322,0.028850020103093586,574
غبهنوش,2019-10-28,20239,19896,0.01694747764133863,343
غبهنوش,2019-10-30,20742,20239,0.024250313372661734,503
غبهنوش,2019-11-02,21776,20742,0.04748346803602666,1034
غبهنوش,2019-11-03,22864,21776,0.047585724280633936,1088
غبهنوش,2019-11-04,24007,22864,0.04761111342326775,1143
غبهنوش,2019-11-05,25083,24007,0.04289758003257595,1076
غبهنوش,2019-11-09,24545,25083,0.02191892442363337,538
غبهنوش,2019-11-10,24236,24545,0.012749628651066611,309
غبهنوش,2019-11-11,23594,24236,0.027210307704195545,642
غبهنوش,2019-11-12,22619,23594,0.04310535390410251,975
غبهنوش,2019-11-13,22601,22619,7.96424936914454e-4,18
غبهنوش,2019-11-16,23153,22601,0.02384140284093459,552
غبهنوش,2019-11-17,23307,23153,0.006607456986887739,154
غبهنوش,2019-11-18,23695,23307,0.016374762607454112,388
غبهنوش,2019-11-19,23703,23695,3.375100198144745e-4,8
غبهنوش,2019-11-20,22916,23703,0.03434281724409396,787
غبهنوش,2019-11-23,22778,22916,0.006058477478002525,138
غبهنوش,2019-11-24,22553,22778,0.009976499800027646,225
غبهنوش,2019-11-25,23058,22553,0.021901292392145836,505
غبهنوش,2019-11-26,24164,23058,0.045770567784896105,1106
غبهنوش,2019-11-27,24105,24164,0.0024476249739702294,59
غبهنوش,2019-11-30,23438,24105,0.02845805956018184,667
غبهنوش,2019-12-01,23562,23438,0.00526271114484073,124
غبهنوش,2019-12-02,24295,23562,0.030170817039301467,733
غبهنوش,2019-12-03,25449,24295,0.045345593145296646,1154
غبهنوش,2019-12-04,26685,25449,0.04631815626583031,1236
غبهنوش,2019-12-07,27688,26685,0.03622507945549606,1003
غبهنوش,2019-12-08,26759,27688,0.034717291377304185,929
غبهنوش,2019-12-09,26005,26759,0.02899442414808712,754
غبهنوش,2019-12-10,27016,26005,0.03742226828407528,1011
غبهنوش,2019-12-11,26881,27016,0.005022134593020269,135
غبهنوش,2019-12-14,26258,26881,0.02372610252023284,623
غبهنوش,2019-12-15,25962,26258,0.011401278791641581,296
غبهنوش,2019-12-16,27042,25962,0.03993787441609578,1080
غبهنوش,2019-12-17,27780,27042,0.026565874729065304,738
غبهنوش,2019-12-18,26848,27780,0.03471394517153181,932
غبهنوش,2019-12-21,26872,26848,8.931229532266625e-4,24
غبهنوش,2019-12-22,26518,26872,0.013349423032907858,354
غبهنوش,2019-12-23,26399,26518,0.004507746505378698,119
غبهنوش,2019-12-24,26212,26399,0.007134137036199674,187
غبهنوش,2019-12-25,25889,26212,0.012476341302774292,323
غبهنوش,2019-12-28,26283,25889,0.014990678384697687,394
غبهنوش,2019-12-29,25991,26283,0.011234658150466136,292
غبهنوش,2019-12-30,25844,25991,0.005687973997613064,147
غبهنوش,2019-12-31,25622,25844,0.008664429005984528,222
غبهنوش,2020-01-01,25520,25622,0.0039968652036051384,102
غبهنوش,2020-01-04,24826,25520,0.027954563762670002,694
غبهنوش,2020-01-05,23876,24826,0.03978890936338629,950
غبهنوش,2020-01-07,22887,23876,0.043212303926105984,989
غبهنوش,2020-01-08,22736,22887,0.006641449683029493,151
غبهنوش,2020-01-11,22760,22736,0.0010544815465266045,24
غبهنوش,2020-01-12,23898,22760,0.04761904761705502,1138
غبهنوش,2020-01-13,25091,23898,0.047546929175897854,1193
غبهنوش,2020-01-14,24431,25091,0.027014858170888834,660
غبهنوش,2020-01-15,24198,24431,0.009628894949597946,233
غبهنوش,2020-01-18,25198,24198,0.03968568933884889,1000
غبهنوش,2020-01-19,26067,25198,0.033337169600132846,869
غبهنوش,2020-01-20,27342,26067,0.046631555846440215,1275
غبهنوش,2020-01-21,28618,27342,0.04458732266249957,1276
غبهنوش,2020-01-22,29481,28618,0.029273091142455375,863
غبهنوش,2020-01-25,30144,29481,0.02199442675086271,663
غبهنوش,2020-01-26,29239,30144,0.03095181093638798,905
غبهنوش,2020-01-27,29630,29239,0.013196085048491527,391
غبهنوش,2020-01-28,31111,29630,0.047603741440403594,1481
غبهنوش,2020-02-01,32666,31111,0.047603012304916335,1555
غبهنوش,2020-02-02,34299,32666,0.04761071751224202,1633
غبهنوش,2020-02-05,35039,34299,0.02111932418102345,740
غبهنوش,2020-02-08,33364,35039,0.05020381249100216,1675
غبهنوش,2020-02-09,32347,33364,0.03144031903943363,1017
غبهنوش,2020-02-10,32400,32347,0.0016358024690853146,53
غبهنوش,2020-02-12,33803,32400,0.04150519184564964,1403
غبهنوش,2020-02-15,34547,33803,0.021535878657436655,744
غبهنوش,2020-02-16,33591,34547,0.028460004166935785,956
غبهنوش,2020-02-17,32198,33591,0.04326355674131115,1393
غبهنوش,2020-02-18,31336,32198,0.027508297165320772,862
غبهنوش,2020-02-19,31448,31336,0.003561434749314378,112
غبهنوش,2020-02-22,30860,31448,0.019053791315001498,588
غبهنوش,2020-02-23,32216,30860,0.042090886514710366,1356
غبهنوش,2020-02-24,32879,32216,0.02016484686212583,663
غبهنوش,2020-02-25,33738,32879,0.025460904617183564,859
غبهنوش,2020-02-26,35325,33738,0.04492569001995964,1587
غبهنوش,2020-02-29,34009,35325,0.038695639388435545,1316
غبهنوش,2020-03-01,33972,34009,0.0010891322265074435,37
غبهنوش,2020-03-02,34204,33972,0.006782832417062834,232
غبهنوش,2020-03-03,33902,34204,0.008908029024573534,302
غبهنوش,2020-03-04,34941,33902,0.029735840415851412,1039
غبهنوش,2020-03-07,36642,34941,0.04642213852828934,1701
غبهنوش,2020-03-09,38462,36642,0.04731943216558371,1820
غبهنوش,2020-03-10,39743,38462,0.032232091185058195,1281
غبهنوش,2020-03-11,40701,39743,0.023537505220423638,958
غبهنوش,2020-03-14,41427,40701,0.01752480266450564,726
غبهنوش,2020-03-15,40844,41427,0.014273822348098281,583
غبهنوش,2020-03-16,40739,40844,0.0025773828517494934,105
غبهنوش,2020-03-17,39705,40739,0.026042060193274347,1034
غبهنوش,2020-03-18,39189,39705,0.013166960116023196,516
غبهنوش,2020-03-24,39825,39189,0.015969868172857,636
غبهنوش,2020-03-25,40327,39825,0.012448235673061516,502
غبهنوش,2020-03-28,40816,40327,0.011980595844473231,489
غبهنوش,2020-03-29,41437,40816,0.014986606172865154,621
غبهنوش,2020-03-30,42058,41437,0.01476532407592455,621
غبهنوش,2020-04-04,42857,42058,0.018643395477549913,799
غبهنوش,2020-04-05,43532,42857,0.015505834787845589,675
غبهنوش,2020-04-06,45240,43532,0.03775419982233081,1708
غبهنوش,2020-04-07,46267,45240,0.02219724641705325,1027
غبهنوش,2020-04-08,46894,46267,0.013370580457769211,627
غبهنوش,2020-04-11,47920,46894,0.02141068447367674,1026
غبهنوش,2020-04-12,48560,47920,0.013179571663649515,640
غبهنوش,2020-04-13,49481,48560,0.018613205068236025,921
غبهنوش,2020-04-14,50797,49481,0.025907041753924307,1316
غبهنوش,2020-04-15,52224,50797,0.027324601715163054,1427
غبهنوش,2020-04-18,53249,52224,0.019249187777812746,1025
غبهنوش,2020-04-19,54634,53249,0.02535051433127081,1385
غبهنوش,2020-04-20,56181,54634,0.02753599971471608,1547
غبهنوش,2020-04-21,57899,56181,0.029672360489305993,1718
غبهنوش,2020-04-22,60793,57899,0.047604164952418794,2894
غبهنوش,2020-04-25,61969,60793,0.018977230550453014,1176
غبهنوش,2020-04-26,64769,61969,0.04323055782792338,2800
غبهنوش,2020-04-27,65900,64769,0.01716236722280482,1131
غبهنوش,2020-04-28,67307,65900,0.02090421501447243,1407
غبهنوش,2020-04-29,68684,67307,0.020048337312619412,1377
غبهنوش,2020-05-02,71072,68684,0.033599729850945524,2388
غبهنوش,2020-05-03,72854,71072,0.024459878661096716,1782
غبهنوش,2020-05-06,75311,72854,0.03262471617648651,2457
غبهنوش,2020-05-09,76668,75311,0.017699692179035588,1357
غبهنوش,2020-05-10,73255,76668,0.046590676403705,3413
غبهنوش,2020-05-11,69889,73255,0.048162085592179577,3366
غبهنوش,2020-05-12,68381,69889,0.02205290943358458,1508
غبهنوش,2020-05-13,66069,68381,0.03499371868750861,2312
غبهنوش,2020-05-16,63576,66069,0.03921291053165954,2493
غبهنوش,2020-05-17,61516,63576,0.0334872228357909,2060
غبهنوش,2020-05-18,63253,61516,0.027461148087403582,1737
غبهنوش,2020-05-19,64384,63253,0.017566476142868315,1131
غبهنوش,2020-05-20,67602,64384,0.047602141947758914,3218
غبهنوش,2020-05-23,69955,67602,0.033635908798032514,2353
غبهنوش,2020-05-26,73407,69955,0.04702548803183586,3452
غبهنوش,2020-05-27,76183,73407,0.036438575534746095,2776
غبهنوش,2020-05-30,78006,76183,0.023369997179404536,1823
غبهنوش,2020-05-31,80203,78006,0.027392990286804822,2197
غبهنوش,2020-06-01,82112,80203,0.0232487334369733,1909
غبهنوش,2020-06-02,83652,82112,0.018409601682943512,1540
غبهنوش,2020-06-06,85962,83652,0.02687233894014946,2310
غبهنوش,2020-06-07,87656,85962,0.01932554531327775,1694
غبهنوش,2020-06-08,91425,87656,0.04122504785298086,3769
غبهنوش,2020-06-09,93379,91425,0.020925475749141397,1954
غبهنوش,2020-06-15,95800,93379,0.025271398747126604,2421
غبهنوش,2020-06-16,98290,95800,0.02533319768007597,2490
غبهنوش,2020-06-20,100820,98290,0.02509422733559716,2530
غبهنوش,2020-06-21,105860,100820,0.0476100510103192,5040
غبهنوش,2020-06-22,108850,105860,0.027468994028227205,2990
غبهنوش,2020-06-23,112210,108850,0.029943855271099336,3360
غبهنوش,2020-06-24,115450,112210,0.028064097011450292,3240
غبهنوش,2020-06-27,119790,115450,0.036230069287618086,4340
غبهنوش,2020-06-28,125770,119790,0.04754710980323172,5980
غبهنوش,2020-06-29,132050,125770,0.04755774327870081,6280
غبهنوش,2020-06-30,138650,132050,0.04760187522504434,6600
غبهنوش,2020-07-01,131720,138650,0.05261160036400993,6930
غبهنوش,2020-07-04,128250,131720,0.027056530214213986,3470
غبهنوش,2020-07-05,123830,128250,0.03569409674524999,4420
غبهنوش,2020-07-06,127990,123830,0.03250253926062581,4160
غبهنوش,2020-07-07,121940,127990,0.0496145645395308,6050
غبهنوش,2020-07-08,117100,121940,0.04133219470502705,4840
غبهنوش,2020-07-11,116070,117100,0.00887395537168197,1030
غبهنوش,2020-07-12,116010,116070,5.171967933754229e-4,60
غبهنوش,2020-07-13,113670,116010,0.02058590657147369,2340
غبهنوش,2020-07-14,109040,113670,0.04246148202455557,4630
غبهنوش,2020-07-15,104050,109040,0.04795771263769383,4990
غبهنوش,2020-07-18,109250,104050,0.04759725400414099,5200
غبهنوش,2020-07-19,112910,109250,0.03241519794497905,3660
غبهنوش,2020-07-20,107510,112910,0.05022788577759997,5400
غبهنوش,2020-07-21,102650,107510,0.04734534827036196,4860
غبهنوش,2020-07-22,99330,102650,0.033423940400348094,3320
غبهنوش,2020-07-25,98640,99330,0.006995133819880423,690
غبهنوش,2020-07-26,94200,98640,0.047133757961283086,4440
غبهنوش,2020-07-27,89820,94200,0.048764195056237324,4380
غبهنوش,2020-07-28,92620,89820,0.03023105160839742,2800
غبهنوش,2020-07-29,97250,92620,0.047609254498225104,4630
غبهنوش,2020-08-01,101490,97250,0.041777515025699305,4240
غبهنوش,2020-08-02,97940,101490,0.036246681641451436,3550
غبهنوش,2020-08-03,93180,97940,0.051083923588204724,4760
غبهنوش,2020-08-04,93110,93180,7.517989474733992e-4,70
غبهنوش,2020-08-05,97380,93110,0.043848839597002996,4270
غبهنوش,2020-08-09,102140,97380,0.04660270217303111,4760
غبهنوش,2020-08-10,97880,102140,0.04352268083322924,4260
غبهنوش,2020-08-11,93010,97880,0.052359961293921516,4870
غبهنوش,2020-08-12,91190,93010,0.01995832876390001,1820
غبهنوش,2020-08-15,87880,91190,0.037664997723740726,3310
غبهنوش,2020-08-16,86510,87880,0.01583631950045271,1370
غبهنوش,2020-08-17,86710,86510,0.0023065390381466207,200
غبهنوش,2020-08-18,89760,86710,0.03397950089088704,3050
غبهنوش,2020-08-19,87510,89760,0.02571134727430338,2250
غبهنوش,2020-08-22,86220,87510,0.014961725817502184,1290
غبهنوش,2020-08-23,83510,86220,0.032451203448300193,2710
غبهنوش,2020-08-24,83090,83510,0.005054759898843968,420
غبهنوش,2020-08-25,83960,83090,0.010362077179485922,870
غبهنوش,2020-08-26,84550,83960,0.006978119455860697,590
غبهنوش,2020-08-31,82600,84550,0.023607748183733564,1950
غبهنوش,2020-09-01,81170,82600,0.01761734630999609,1430
غبهنوش,2020-09-02,80980,81170,0.0023462583353624816,190
غبهنوش,2020-09-05,79000,80980,0.025063291138923253,1980
غبهنوش,2020-09-06,76510,79000,0.03254476538971972,2490
غبهنوش,2020-09-07,75240,76510,0.01687931951067412,1270
غبهنوش,2020-09-08,74010,75240,0.016619375759807875,1230
غبهنوش,2020-09-09,72130,74010,0.02606405101863214,1880
پاسا,2018-01-15,1750,1754,0.002285714284408163,4
پاسا,2018-01-16,1811,1750,0.033683048021157895,61
پاسا,2018-01-17,1769,1811,0.02374222723361095,42
پاسا,2018-01-20,1686,1769,0.04922894421753918,83
پاسا,2018-01-21,1647,1686,0.02367941710766277,39
پاسا,2018-01-22,1616,1647,0.019183168304960908,31
پاسا,2018-01-23,1620,1616,0.0024691358009449778,4
پاسا,2018-01-24,1627,1620,0.004302397047140505,7
پاسا,2018-01-27,1667,1627,0.023995200945413794,40
پاسا,2018-01-28,1659,1667,0.0048221820344652305,8
پاسا,2018-01-29,1643,1659,0.009738283621583516,16
پاسا,2018-01-30,1641,1643,0.001218769042523602,2
پاسا,2018-01-31,1636,1641,0.0030562347169582915,5
پاسا,2018-02-03,1630,1636,0.0036809815928337533,6
پاسا,2018-02-04,1592,1630,0.023869346718675032,38
پاسا,2018-02-05,1609,1592,0.01056556866962985,17
پاسا,2018-02-06,1613,1609,0.0024798512073900486,4
پاسا,2018-02-07,1609,1613,0.002486016157559965,4
پاسا,2018-02-10,1631,1609,0.013488657257211123,22
پاسا,2018-02-12,1626,1631,0.00307503074841634,5
پاسا,2018-02-13,1628,1626,0.0012285012277466207,2
پاسا,2018-02-14,1602,1628,0.016229712848795434,26
پاسا,2018-02-17,1621,1602,0.011721159770684046,19
پاسا,2018-02-18,1618,1621,0.0018541409135635716,3
پاسا,2018-02-19,1594,1618,0.015056461722047387,24
پاسا,2018-02-21,1558,1594,0.02310654684011133,36
پاسا,2018-02-24,1626,1558,0.04182041817846222,68
پاسا,2018-02-25,1617,1626,0.005565862705277759,9
پاسا,2018-02-26,1607,1617,0.006222775353937289,10
پاسا,2018-02-27,1591,1607,0.01005656818978217,16
پاسا,2018-02-28,1588,1591,0.00188916876455342,3
پاسا,2018-03-03,1593,1588,0.0031387319503209466,5
پاسا,2018-03-04,1524,1593,0.04527559052147271,69
پاسا,2018-03-05,1572,1524,0.030534351125614277,48
پاسا,2018-03-06,1630,1572,0.03558282206405962,58
پاسا,2018-03-07,1591,1630,0.024512884962594038,39
پاسا,2018-03-10,1563,1591,0.01791426742295952,28
پاسا,2018-03-11,1492,1563,0.04758713133539736,71
پاسا,2018-03-12,1480,1492,0.008108108102629656,12
پاسا,2018-03-13,1477,1480,0.0020311442098638155,3
پاسا,2018-03-14,1454,1477,0.015818431901087733,23
پاسا,2018-03-17,1463,1454,0.006151742989643374,9
پاسا,2018-03-18,1468,1463,0.003405994548088559,5
پاسا,2018-03-19,1469,1468,6.807351935461299e-4,1
پاسا,2018-03-25,1475,1469,0.004067796607411663,6
پاسا,2018-03-26,1477,1475,0.0013540961399092105,2
پاسا,2018-03-27,1475,1477,0.0013559322024705544,2
پاسا,2018-03-28,1471,1475,0.0027192386113397424,4
پاسا,2018-04-03,1470,1471,6.802721083807672e-4,1
پاسا,2018-04-04,1448,1470,0.015193370155253197,22
پاسا,2018-04-07,1439,1448,0.006254343289607822,9
پاسا,2018-04-08,1399,1439,0.028591851301935773,40
پاسا,2018-04-09,1349,1399,0.0370644921889811,50
پاسا,2018-04-10,1299,1349,0.038491147006550305,50
پاسا,2018-04-11,1249,1299,0.04003202558844513,50
پاسا,2018-04-15,1193,1249,0.046940486129974444,56
پاسا,2018-04-16,1170,1193,0.019658119641317844,23
پاسا,2018-04-17,1160,1170,0.008620689647740784,10
پاسا,2018-04-18,1163,1160,0.0025795356813589545,3
پاسا,2018-04-21,1195,1163,0.026778242655415695,32
پاسا,2018-04-22,1188,1195,0.00589225588729608,7
پاسا,2018-04-23,1184,1188,0.003378378375525018,4
پاسا,2018-04-24,1223,1184,0.03188879801153818,39
پاسا,2018-04-25,1269,1223,0.0362490149438542,46
پاسا,2018-04-28,1239,1269,0.024213075040990253,30
پاسا,2018-04-29,1216,1239,0.018914473668655857,23
پاسا,2018-04-30,1181,1216,0.0296359017530602,35
پاسا,2018-05-01,1172,1181,0.007679180880819811,9
پاسا,2018-05-05,1165,1172,0.006008583685829541,7
پاسا,2018-05-06,1143,1165,0.019247594033904115,22
پاسا,2018-05-07,1151,1143,0.006950477839313225,8
پاسا,2018-05-08,1178,1151,0.02292020371568743,27
پاسا,2018-05-09,1127,1178,0.045252883722047124,51
پاسا,2018-05-12,1126,1127,8.88099466351599e-4,1
پاسا,2018-05-13,1137,1126,0.00967458222544012,11
پاسا,2018-05-14,1180,1137,0.03644067793521976,43
پاسا,2018-05-15,1170,1180,0.00854700853970341,10
پاسا,2018-05-16,1172,1170,0.0017064846401821801,2
پاسا,2018-05-19,1173,1172,8.525149182843009e-4,1
پاسا,2018-05-20,1166,1173,0.006003430526583678,7
پاسا,2018-05-21,1143,1166,0.020122484671808848,23
پاسا,2018-05-22,1141,1143,0.0017528483770790108,2
پاسا,2018-05-23,1144,1141,0.002622377620085334,3
پاسا,2018-05-26,1171,1144,0.023057216034963947,27
پاسا,2018-05-27,1178,1171,0.005942275037400445,7
پاسا,2018-05-28,1211,1178,0.027250206418455648,33
پاسا,2018-05-29,1271,1211,0.04720692364499848,60
پاسا,2018-05-30,1322,1271,0.03857791222497888,51
پاسا,2018-06-02,1316,1322,0.004559270513252833,6
پاسا,2018-06-03,1322,1316,0.004538577908821045,6
پاسا,2018-06-09,1373,1322,0.03714493806471599,51
پاسا,2018-06-10,1427,1373,0.03784162576184889,54
پاسا,2018-06-11,1407,1427,0.01421464107020992,20
پاسا,2018-06-12,1422,1407,0.010548523199332964,15
پاسا,2018-06-13,1488,1422,0.04435483867986906,66
پاسا,2018-06-17,1524,1488,0.023622047228594456,36
پاسا,2018-06-18,1457,1524,0.045984900448877895,67
پاسا,2018-06-19,1399,1457,0.04145818438780687,58
پاسا,2018-06-20,1391,1399,0.005751258083572065,8
پاسا,2018-06-23,1424,1391,0.0231741572870968,33
پاسا,2018-06-24,1487,1424,0.042367182217641436,63
پاسا,2018-06-25,1550,1487,0.040645161264099894,63
پاسا,2018-06-26,1501,1550,0.03264490337598607,49
پاسا,2018-06-27,1430,1501,0.04965034961562912,71
پاسا,2018-06-30,1402,1430,0.019971469315284256,28
پاسا,2018-07-01,1388,1402,0.010086455324145205,14
پاسا,2018-07-02,1408,1388,0.014204545444456998,20
پاسا,2018-07-08,1360,1408,0.03529411762110726,48
پاسا,2018-07-10,1378,1360,0.013062409279345131,18
پاسا,2018-07-11,1331,1378,0.035311795615843876,47
پاسا,2018-07-14,1335,1331,0.002996254679403554,4
پاسا,2018-07-15,1317,1335,0.013667425957731643,18
پاسا,2018-07-16,1310,1317,0.005343511446302663,7
پاسا,2018-07-17,1314,1310,0.003044140028124703,4
پاسا,2018-07-18,1307,1314,0.005355776583507439,7
پاسا,2018-07-21,1363,1307,0.04108584002855037,56
پاسا,2018-07-22,1366,1363,0.0021961932633995655,3
پاسا,2018-07-23,1333,1366,0.024756189028690027,33
پاسا,2018-07-24,1329,1333,0.0030097817885554688,4
پاسا,2018-07-25,1321,1329,0.0060560181634700845,8
پاسا,2018-07-28,1270,1321,0.04015748028334056,51
پاسا,2018-07-29,1267,1270,0.0023677979460396226,3
پاسا,2018-07-30,1216,1267,0.041940789439193424,51
پاسا,2018-07-31,1274,1216,0.04552590263302519,58
پاسا,2018-08-01,1253,1274,0.016759776522937128,21
پاسا,2018-08-04,1283,1253,0.023382696786139752,30
پاسا,2018-08-05,1311,1283,0.021357742165249622,28
پاسا,2018-08-06,1266,1311,0.035545023668605825,45
پاسا,2018-08-07,1265,1266,7.905138333671826e-4,1
پاسا,2018-08-08,1275,1265,0.00784313724875048,10
پاسا,2018-08-11,1248,1275,0.021634615367279952,27
پاسا,2018-08-12,1249,1248,8.006405117689027e-4,1
پاسا,2018-08-13,1308,1249,0.045107033604658224,59
پاسا,2018-08-14,1280,1308,0.021874999982910155,28
پاسا,2018-08-15,1326,1280,0.034690799370519755,46
پاسا,2018-08-18,1384,1326,0.04190751442058705,58
پاسا,2018-08-19,1450,1384,0.04551724134791914,66
پاسا,2018-08-20,1475,1450,0.01694915253088193,25
پاسا,2018-08-21,1416,1475,0.04166666663724105,59
پاسا,2018-08-25,1464,1416,0.03278688522350622,48
پاسا,2018-08-26,1509,1464,0.029821073538885967,45
پاسا,2018-08-27,1502,1509,0.00466045272659091,7
پاسا,2018-08-28,1564,1502,0.03964194370866883,62
پاسا,2018-08-29,1533,1564,0.020221787331884025,31
پاسا,2018-09-01,1603,1533,0.043668122243500855,70
پاسا,2018-09-02,1603,1603,0,0
پاسا,2018-09-03,1647,1603,0.02671523981377338,44
پاسا,2018-09-04,1713,1647,0.038528896650012315,66
پاسا,2018-09-05,1681,1713,0.019036287912530463,32
پاسا,2018-09-08,1753,1681,0.04107244720988451,72
پاسا,2018-09-09,1757,1753,0.0022766078530013613,4
پاسا,2018-09-10,1787,1757,0.016787912693459476,30
پاسا,2018-09-11,1791,1787,0.002233389166815528,4
پاسا,2018-09-12,1863,1791,0.038647342974424397,72
پاسا,2018-09-15,1952,1863,0.04559426227172425,89
پاسا,2018-09-16,1926,1952,0.013499480782191339,26
پاسا,2018-09-17,2006,1926,0.03988035890334977,80
پاسا,2018-09-18,2067,2006,0.029511369119733254,61
پاسا,2018-09-22,2096,2067,0.013835877855994334,29
پاسا,2018-09-23,2185,2096,0.04073226542758249,89
پاسا,2018-09-24,2294,2185,0.04751525717196371,109
پاسا,2018-09-25,2408,2294,0.04734219267136952,114
پاسا,2018-09-26,2528,2408,0.04746835441160271,120
پاسا,2018-10-01,2441,2528,0.03564113066954481,87
پاسا,2018-10-02,2352,2441,0.03784013603833328,89
پاسا,2018-10-03,2269,2352,0.036579991169422656,83
پاسا,2018-10-06,2330,2269,0.026180257499493452,61
پاسا,2018-10-07,2297,2330,0.014366565078638848,33
پاسا,2018-10-08,2213,2297,0.03795752370630026,84
پاسا,2018-10-09,2319,2213,0.04570935746196233,106
پاسا,2018-10-10,2215,2319,0.04695259591559702,104
پاسا,2018-10-13,2114,2215,0.047776726562073456,101
پاسا,2018-10-14,2010,2114,0.05174129350659637,104
پاسا,2018-10-15,2108,2010,0.04648956354530856,98
پاسا,2018-10-16,2195,2108,0.03963553528945989,87
پاسا,2018-10-17,2117,2195,0.036844591385524525,78
پاسا,2018-10-20,2222,2117,0.0472547254512805,105
پاسا,2018-10-21,2274,2222,0.022867194361096223,52
پاسا,2018-10-22,2179,2274,0.04359798070509501,95
پاسا,2018-10-23,2096,2179,0.03959923662232861,83
پاسا,2018-10-24,2060,2096,0.017475728146856443,36
پاسا,2018-10-27,2159,2060,0.04585456227612109,99
پاسا,2018-10-28,2245,2159,0.03830734964886087,86
پاسا,2018-10-29,2336,2245,0.03895547943537865,91
پاسا,2018-10-31,2296,2336,0.01742160277986864,40
پاسا,2018-11-03,2229,2296,0.030058322104056383,67
پاسا,2018-11-04,2138,2229,0.04256314310450742,91
پاسا,2018-11-05,2239,2138,0.04510942382978588,101
پاسا,2018-11-06,2253,2239,0.006213936970166917,14
پاسا,2018-11-10,2260,2253,0.0030973451313728562,7
پاسا,2018-11-11,2360,2260,0.04237288133797759,100
پاسا,2018-11-12,2478,2360,0.0476190475998309,118
پاسا,2018-11-13,2601,2478,0.047289504018727606,123
پاسا,2018-11-14,2600,2601,3.8461538446745564e-4,1
پاسا,2018-11-17,2715,2600,0.04235727438587209,115
پاسا,2018-11-18,2672,2715,0.016092814365234725,43
پاسا,2018-11-19,2804,2672,0.047075606259958776,132
پاسا,2018-11-20,2701,2804,0.038134024421275815,103
پاسا,2018-11-21,2678,2701,0.00858849887655396,23
پاسا,2018-11-24,2557,2678,0.04732107937140357,121
پاسا,2018-11-26,2441,2557,0.04752150755939308,116
پاسا,2018-11-27,2505,2441,0.02554890218540962,64
پاسا,2018-11-28,2457,2505,0.01953601952806837,48
پاسا,2018-12-01,2341,2457,0.04955147370800877,116
پاسا,2018-12-02,2380,2341,0.016386554614963633,39
پاسا,2018-12-03,2401,2380,0.0087463556814884,21
پاسا,2018-12-04,2305,2401,0.04164859000362317,96
پاسا,2018-12-05,2413,2305,0.04475756318078841,108
پاسا,2018-12-08,2483,2413,0.028191703573019856,70
پاسا,2018-12-09,2424,2483,0.024339933983358115,59
پاسا,2018-12-10,2365,2424,0.024947145866829962,59
پاسا,2018-12-11,2371,2365,0.0025305778142005156,6
پاسا,2018-12-12,2480,2371,0.04395161288550339,109
پاسا,2018-12-15,2516,2480,0.014308426067444983,36
پاسا,2018-12-16,2530,2516,0.005533596835757472,14
پاسا,2018-12-17,2488,2530,0.016881028932121775,42
پاسا,2018-12-18,2422,2488,0.02725020642970677,66
پاسا,2018-12-19,2390,2422,0.013389121333309991,32
پاسا,2018-12-22,2458,2390,0.027664768092894726,68
پاسا,2018-12-23,2563,2458,0.04096761605892797,105
پاسا,2018-12-24,2506,2563,0.022745411004491057,57
پاسا,2018-12-25,2517,2506,0.004370282080107158,11
پاسا,2018-12-26,2527,2517,0.003957261573424115,10
پاسا,2018-12-29,2636,2527,0.041350531092052153,109
پاسا,2018-12-30,2647,2636,0.004155647901716793,11
پاسا,2018-12-31,2717,2647,0.02576370996475388,70
پاسا,2019-01-01,2779,2717,0.022310183511223398,62
پاسا,2019-01-02,2693,2779,0.031934645365044693,86
پاسا,2019-01-05,2702,2693,0.0033308660239338025,9
پاسا,2019-01-06,2819,2702,0.04150407944607872,117
پاسا,2019-01-07,2896,2819,0.026588397780874174,77
پاسا,2019-01-08,2879,2896,0.0059048280632494525,17
پاسا,2019-01-09,2835,2879,0.015520282181474328,44
پاسا,2019-01-12,2867,2835,0.011161492845775552,32
پاسا,2019-01-13,2807,2867,0.02137513358697003,60
پاسا,2019-01-14,2706,2807,0.03732446413993922,101
پاسا,2019-01-15,2778,2706,0.025917926556545023,72
پاسا,2019-01-16,2848,2778,0.024578651676763114,70
پاسا,2019-01-19,2842,2848,0.0021111893025646767,6
پاسا,2019-01-20,2823,2842,0.006730428619649158,19
پاسا,2019-01-21,2687,2823,0.05061406771469518,136
پاسا,2019-01-22,2709,2687,0.008121077885521936,22
پاسا,2019-01-23,2682,2709,0.010067114090206147,27
پاسا,2019-01-26,2760,2682,0.028260869554977947,78
پاسا,2019-01-27,2898,2760,0.04761904760261593,138
پاسا,2019-01-28,3023,2898,0.04134965264923928,125
پاسا,2019-01-29,3003,3023,0.006660006657788876,20
پاسا,2019-01-30,3127,3003,0.03965462102985142,124
پاسا,2019-02-02,3191,3127,0.020056408643040927,64
پاسا,2019-02-03,3037,3191,0.05070793544593088,154
پاسا,2019-02-04,3071,3037,0.011071312272526437,34
پاسا,2019-02-05,3175,3071,0.0327559055014942,104
پاسا,2019-02-06,3130,3175,0.014376996800518531,45
پاسا,2019-02-10,3138,3130,0.002549394517989358,8
پاسا,2019-02-12,3109,3138,0.009327758118582259,29
پاسا,2019-02-13,3067,3109,0.0136941636733961,42
پاسا,2019-02-16,3012,3067,0.01826029215861212,55
پاسا,2019-02-17,2870,3012,0.049477351899136816,142
پاسا,2019-02-18,2914,2870,0.015099519555559535,44
پاسا,2019-02-19,3036,2914,0.040184453214695506,122
پاسا,2019-02-20,3139,3036,0.03281299775953712,103
پاسا,2019-02-23,3228,3139,0.027571251540405437,89
پاسا,2019-02-24,3155,3228,0.02313787637935408,73
پاسا,2019-02-25,3167,3155,0.003789074833031552,12
پاسا,2019-02-26,3114,3167,0.017019910078028288,53
پاسا,2019-02-27,3191,3114,0.024130366648658613,77
پاسا,2019-03-02,3271,3191,0.02445735248411576,80
پاسا,2019-03-03,3280,3271,0.002743902438187835,9
پاسا,2019-03-04,3200,3280,0.0249999999921875,80
پاسا,2019-03-05,3166,3200,0.010739102965654106,34
پاسا,2019-03-06,3267,3166,0.030915212723931676,101
پاسا,2019-03-09,3235,3267,0.009891808343155546,32
پاسا,2019-03-10,3288,3235,0.016119221406289776,53
پاسا,2019-03-11,3412,3288,0.03634232120857494,124
پاسا,2019-03-12,3356,3412,0.016686531580248354,56
پاسا,2019-03-13,3333,3356,0.006900690066936487,23
پاسا,2019-03-16,3256,3333,0.02364864864138555,77
پاسا,2019-03-17,3221,3256,0.010866190620656259,35
پاسا,2019-03-18,3271,3221,0.01528584530257235,50
پاسا,2019-03-19,3267,3271,0.0012243648603537298,4
پاسا,2019-03-25,3213,3267,0.01680672268384478,54
پاسا,2019-03-26,3264,3213,0.01562499999521293,51
پاسا,2019-03-27,3275,3264,0.0033587786249286173,11
پاسا,2019-03-30,3330,3275,0.0165165165115566,55
پاسا,2019-03-31,3336,3330,0.0017985611505399997,6
پاسا,2019-04-06,3470,3336,0.03861671468627761,134
پاسا,2019-04-07,3577,3470,0.029913335188729847,107
پاسا,2019-04-08,3479,3577,0.028169014076410172,98
پاسا,2019-04-09,3428,3479,0.01487747957559,51
پاسا,2019-04-10,3542,3428,0.032185206089162845,114
پاسا,2019-04-13,3695,3542,0.04140730716064755,153
پاسا,2019-04-14,3871,3695,0.0454662877691898,176
پاسا,2019-04-15,4064,3871,0.04749015746862939,193
پاسا,2019-04-16,4257,4064,0.04533709183806974,193
پاسا,2019-04-17,4398,4257,0.032060027277839916,141
پاسا,2019-04-20,4588,4398,0.0414123801130313,190
پاسا,2019-04-22,4815,4588,0.04714434059249338,227
پاسا,2019-04-23,4949,4815,0.027076176999984606,134
پاسا,2019-04-28,5394,4949,0.0824990730288285,445
پاسا,2019-04-29,5652,5394,0.045647558378335534,258
پاسا,2019-04-30,5910,5652,0.04365482232763877,258
پاسا,2019-05-01,6147,5910,0.03855539286830073,237
پاسا,2019-05-04,6454,6147,0.04756740005460684,307
پاسا,2019-05-05,6474,6454,0.0030892801972367497,20
پاسا,2019-05-06,6161,6474,0.05080344099159171,313
پاسا,2019-05-07,5855,6161,0.05226302304828983,306
پاسا,2019-05-08,5901,5855,0.007795288932757958,46
پاسا,2019-05-11,6096,5901,0.031988188971130545,195
پاسا,2019-05-12,5867,6096,0.039031873182370565,229
پاسا,2019-05-13,6085,5867,0.0358258011444822,218
پاسا,2019-05-14,6234,6085,0.023901187034985373,149
پاسا,2019-05-15,6048,6234,0.03075396824888327,186
پاسا,2019-05-18,5874,6048,0.029622063324885584,174
پاسا,2019-05-19,5815,5874,0.0101461736869912,59
پاسا,2019-05-20,5545,5815,0.04869251577120062,270
پاسا,2019-05-21,5777,5545,0.04015925220007629,232
پاسا,2019-05-22,6048,5777,0.04480820105079229,271
پاسا,2019-05-25,6292,6048,0.038779402409602766,244
پاسا,2019-05-26,6201,6292,0.014675052408534905,91
پاسا,2019-05-28,6440,6201,0.03711180123647332,239
پاسا,2019-05-29,6714,6440,0.04081024723848522,274
پاسا,2019-06-01,7048,6714,0.04738933029974612,334
پاسا,2019-06-02,7389,7048,0.04614968195342405,341
پاسا,2019-06-03,7434,7389,0.006053268764318904,45
پاسا,2019-06-08,7131,7434,0.04249053428095771,303
پاسا,2019-06-09,7325,7131,0.026484641634609604,194
پاسا,2019-06-10,7683,7325,0.046596381615697464,358
پاسا,2019-06-11,7674,7683,0.001172791243005891,9
پاسا,2019-06-12,7535,7674,0.018447246182024254,139
پاسا,2019-06-15,7162,7535,0.05208042445516889,373
پاسا,2019-06-16,6895,7162,0.03872371282977176,267
پاسا,2019-06-17,6602,6895,0.044380490753653364,293
پاسا,2019-06-18,6896,6602,0.042633410666671485,294
پاسا,2019-06-19,6863,6896,0.0048083928304227894,33
پاسا,2019-06-22,6723,6863,0.020824036885196483,140
پاسا,2019-06-23,7045,6723,0.04570617458542141,322
پاسا,2019-06-24,7310,7045,0.036251709981360916,265
پاسا,2019-06-30,7706,7310,0.051388528412744806,396
پاسا,2019-07-01,7403,7706,0.04092935295948543,303
پاسا,2019-07-02,7702,7403,0.03882108542731484,299
پاسا,2019-07-03,8087,7702,0.04760727092276403,385
پاسا,2019-07-10,8891,8087,0.09042852321556309,804
پاسا,2019-07-13,8482,8891,0.04821975948500121,409
پاسا,2019-07-14,8090,8482,0.04845488256508592,392
پاسا,2019-07-15,7853,8090,0.030179549213016736,237
پاسا,2019-07-16,7462,7853,0.052398820684481526,391
پاسا,2019-07-17,7189,7462,0.03797468353902146,273
پاسا,2019-07-20,6876,7189,0.04552065153497373,313
پاسا,2019-07-21,7211,6876,0.04645680210144823,335
پاسا,2019-07-22,7571,7211,0.047549861306623975,360
پاسا,2019-07-23,7361,7571,0.02852873250529429,210
پاسا,2019-07-24,7006,7361,0.05067085354686399,355
پاسا,2019-07-27,6686,7006,0.04786120250555471,320
پاسا,2019-07-28,6795,6686,0.016041206767322853,109
پاسا,2019-07-29,6857,6795,0.009041855037328007,62
پاسا,2019-07-30,6970,6857,0.016212338591648157,113
پاسا,2019-07-31,6771,6970,0.02939004577914783,199
پاسا,2019-08-03,6653,6771,0.017736359534385033,118
پاسا,2019-08-04,6852,6653,0.029042615290565874,199
پاسا,2019-08-05,7181,6852,0.0458153460457018,329
پاسا,2019-08-06,7290,7181,0.014951989024012072,109
پاسا,2019-08-07,7092,7290,0.027918781721951665,198
پاسا,2019-08-10,7334,7092,0.0329970002682033,242
پاسا,2019-08-11,7490,7334,0.020827770357699896,156
پاسا,2019-08-13,7404,7490,0.011615343056237798,86
پاسا,2019-08-14,7495,7404,0.012141427616792337,91
پاسا,2019-08-17,7813,7495,0.04070139510550347,318
پاسا,2019-08-18,8102,7813,0.03567020488327941,289
پاسا,2019-08-19,8486,8102,0.04525100164444367,384
پاسا,2019-08-21,8628,8486,0.016458043577137454,142
پاسا,2019-08-24,8451,8628,0.020944266948178407,177
پاسا,2019-08-25,8064,8451,0.04799107142262015,387
پاسا,2019-08-26,8100,8064,0.004444444443895747,36
پاسا,2019-08-27,8118,8100,0.0022172948999485964,18
پاسا,2019-08-28,8007,8118,0.01386286998702849,111
پاسا,2019-08-31,8209,8007,0.024607138503519657,202
پاسا,2019-09-01,8094,8209,0.014208055347886328,115
پاسا,2019-09-02,7914,8094,0.022744503408801554,180
پاسا,2019-09-03,7651,7914,0.034374591552166434,263
پاسا,2019-09-04,7693,7651,0.005459508643512348,42
پاسا,2019-09-07,7963,7693,0.03390681903379294,270
پاسا,2019-09-08,7913,7963,0.006318716036102778,50
پاسا,2019-09-11,7896,7913,0.002152988854843846,17
پاسا,2019-09-14,8140,7896,0.02997542997174749,244
پاسا,2019-09-15,7964,8140,0.022099447511037235,176
پاسا,2019-09-16,7968,7964,5.02008032065511e-4,4
پاسا,2019-09-17,7957,7968,0.0013824305641092836,11
پاسا,2019-09-18,7604,7957,0.04642293529110692,353
پاسا,2019-09-21,7755,7604,0.019471308830500154,151
پاسا,2019-09-22,7830,7755,0.009578544060079368,75
پاسا,2019-09-23,8027,7830,0.024542170172599704,197
پاسا,2019-09-24,8422,8027,0.04690097363489658,395
پاسا,2019-09-25,8843,8422,0.04760827772841702,421
پاسا,2019-09-28,9285,8843,0.04760366181501307,442
پاسا,2019-09-29,9374,9285,0.009494346062567277,89
پاسا,2019-09-30,9229,9374,0.01571134467269354,145
پاسا,2019-10-01,8895,9229,0.03754918493113556,334
پاسا,2019-10-02,8528,8895,0.043034709188199495,367
پاسا,2019-10-05,8949,8528,0.04704436249334625,421
پاسا,2019-10-06,9124,8949,0.01918018412766548,175
پاسا,2019-10-07,9312,9124,0.020189003434258054,188
پاسا,2019-10-08,8894,9312,0.046997976158421634,418
پاسا,2019-10-09,8555,8894,0.039625949732364,339
پاسا,2019-10-12,8980,8555,0.04732739420408381,425
پاسا,2019-10-13,8699,8980,0.03230256350933411,281
پاسا,2019-10-14,8272,8699,0.05161992262432061,427
پاسا,2019-10-15,7955,8272,0.03984915147204913,317
پاسا,2019-10-16,7559,7955,0.05238788198804235,396
پاسا,2019-10-20,7423,7559,0.018321433380261157,136
پاسا,2019-10-21,7054,7423,0.05231074566879632,369
پاسا,2019-10-22,6834,7054,0.032191981265409425,220
پاسا,2019-10-23,6903,6834,0.009995654062002658,69
پاسا,2019-10-26,7179,6903,0.03844546593697653,276
پاسا,2019-10-28,7382,7179,0.027499322673056173,203
پاسا,2019-10-30,7627,7382,0.03212272190479576,245
پاسا,2019-11-02,7605,7627,0.0028928336616840453,22
پاسا,2019-11-03,7469,7605,0.018208595525745268,136
پاسا,2019-11-04,7145,7469,0.04534639607482906,324
پاسا,2019-11-05,7145,7145,0,0
پاسا,2019-11-09,7368,7145,0.030266015196760854,223
پاسا,2019-11-10,7722,7368,0.04584304583710916,354
پاسا,2019-11-11,7683,7722,0.005076142131318997,39
پاسا,2019-11-12,7829,7683,0.01864861412458186,146
پاسا,2019-11-13,7877,7829,0.00609369049053019,48
پاسا,2019-11-16,8208,7877,0.04032651071633449,331
پاسا,2019-11-17,7811,8208,0.05082575853913381,397
پاسا,2019-11-18,7782,7811,0.0037265484446509186,29
پاسا,2019-11-19,7863,7782,0.010301411673623119,81
پاسا,2019-11-20,7596,7863,0.035150078984314104,267
پاسا,2019-11-23,7472,7596,0.016595289077008125,124
پاسا,2019-11-24,7498,7472,0.0034675913572329163,26
پاسا,2019-11-25,7718,7498,0.028504793984386524,220
پاسا,2019-11-26,7695,7718,0.0029889538657584206,23
پاسا,2019-11-27,7463,7695,0.031086694354671485,232
پاسا,2019-11-30,7822,7463,0.045896190226809484,359
پاسا,2019-12-01,8142,7822,0.039302382702124494,320
پاسا,2019-12-02,8476,8142,0.03940537989152839,334
پاسا,2019-12-03,8676,8476,0.023052097738237423,200
پاسا,2019-12-04,8877,8676,0.022642784722018385,201
پاسا,2019-12-07,9070,8877,0.021278941563254803,193
پاسا,2019-12-08,8805,9070,0.030096536055639233,265
پاسا,2019-12-09,9105,8805,0.03294892915618353,300
پاسا,2019-12-10,9067,9105,0.0041910223884205336,38
پاسا,2019-12-11,9059,9067,8.830996797788829e-4,8
پاسا,2019-12-14,9298,9059,0.025704452567680742,239
پاسا,2019-12-15,9190,9298,0.011751904242464428,108
پاسا,2019-12-16,9332,9190,0.015216459492582891,142
پاسا,2019-12-17,9798,9332,0.04756072667405994,466
پاسا,2019-12-18,10261,9798,0.045122307762876686,463
پاسا,2019-12-21,10719,10261,0.04272786640146209,458
پاسا,2019-12-22,10910,10719,0.017506874425526408,191
پاسا,2019-12-23,10507,10910,0.038355382122551115,403
پاسا,2019-12-24,10348,10507,0.015365287976868449,159
پاسا,2019-12-25,10313,10348,0.0033937748469510544,35
پاسا,2019-12-28,10814,10313,0.046328832989982534,501
پاسا,2019-12-29,10606,10814,0.019611540635525972,208
پاسا,2019-12-30,10508,10606,0.009326227635199255,98
پاسا,2019-12-31,10351,10508,0.015167616653930285,157
پاسا,2020-01-01,10447,10351,0.009189240929531039,96
پاسا,2020-01-04,9925,10447,0.05259445843298796,522
پاسا,2020-01-05,9429,9925,0.05260366952459394,496
پاسا,2020-01-07,8958,9429,0.05257870059694366,471
پاسا,2020-01-08,8810,8958,0.016799091939069342,148
پاسا,2020-01-11,8986,8810,0.019586022699801243,176
پاسا,2020-01-19,6640,8986,0.35331325295883836,2346
پاسا,2020-01-20,6972,6640,0.04761904761221757,332
پاسا,2020-01-21,7320,6972,0.0475409836000627,348
پاسا,2020-01-22,7686,7320,0.04761904761285206,366
پاسا,2020-01-25,8070,7686,0.04758364311678021,384
پاسا,2020-01-26,8473,8070,0.047562846683870785,403
پاسا,2020-01-27,8896,8473,0.047549460426309635,423
پاسا,2020-01-28,9340,8896,0.047537473228315044,444
پاسا,2020-02-01,9660,9340,0.033126293992429987,320
پاسا,2020-02-02,10052,9660,0.03899721448080012,392
پاسا,2020-02-04,10482,10052,0.04102270558662252,430
پاسا,2020-02-05,10037,10482,0.04433595695483352,445
پاسا,2020-02-08,9614,10037,0.043998335755773006,423
پاسا,2020-02-09,9238,9614,0.04070145052601196,376
پاسا,2020-02-10,8990,9238,0.02758620689348318,248
پاسا,2020-02-12,9392,8990,0.04280238500396056,402
پاسا,2020-02-15,9308,9392,0.009024495057045069,84
پاسا,2020-02-16,9207,9308,0.010969914194529171,101
پاسا,2020-02-17,8914,9207,0.03286964325410931,293
پاسا,2020-02-18,9064,8914,0.016548984993761146,150
پاسا,2020-02-19,9517,9064,0.04759903330381433,453
پاسا,2020-02-22,9992,9517,0.047538030419581864,475
پاسا,2020-02-23,10491,9992,0.04756457915855833,499
پاسا,2020-02-24,11008,10491,0.046965843018989296,517
پاسا,2020-02-25,11474,11008,0.040613561091109154,466
پاسا,2020-02-26,11980,11474,0.04223706176609039,506
پاسا,2020-02-29,11432,11980,0.047935619310012625,548
پاسا,2020-03-01,11874,11432,0.037224187296848225,442
پاسا,2020-03-02,12258,11874,0.031326480663132115,384
پاسا,2020-03-03,12781,12258,0.04092011579368437,523
پاسا,2020-03-04,13201,12781,0.03181577153004956,420
پاسا,2020-03-07,12732,13201,0.036836317936158,469
پاسا,2020-03-09,12622,12732,0.00871494216378427,110
پاسا,2020-03-10,12401,12622,0.017821143454735816,221
پاسا,2020-03-11,12021,12401,0.031611346807119925,380
پاسا,2020-03-14,11807,12021,0.018124841194365644,214
پاسا,2020-03-15,11657,11807,0.012867804751405353,150
پاسا,2020-03-16,11354,11657,0.02668663026011215,303
پاسا,2020-03-17,10996,11354,0.032557293558334185,358
پاسا,2020-03-18,11150,10996,0.013811659191586398,154
پاسا,2020-03-24,11337,11150,0.016494663489768486,187
پاسا,2020-03-25,11583,11337,0.021238021236187687,246
پاسا,2020-03-28,11755,11583,0.014632071457708883,172
پاسا,2020-03-29,11902,11755,0.012350865399735265,147
پاسا,2020-03-30,11366,11902,0.04715819109210292,536
پاسا,2020-04-04,11700,11366,0.028547008544568632,334
پاسا,2020-04-05,12173,11700,0.03885648566180428,473
پاسا,2020-04-06,12699,12173,0.0414205842947145,526
پاسا,2020-04-07,13151,12699,0.034370009882566346,452
پاسا,2020-04-08,13329,13151,0.013354340159550279,178
پاسا,2020-04-11,13994,13329,0.047520365867691844,665
پاسا,2020-04-12,14170,13994,0.012420606915143217,176
پاسا,2020-04-13,14835,14170,0.04482642399428201,665
پاسا,2020-04-14,15125,14835,0.019173553717740592,290
پاسا,2020-04-15,15342,15125,0.014144179375952016,217
پاسا,2020-04-18,15691,15342,0.02224204958114575,349
پاسا,2020-04-19,16253,15691,0.034578231708941226,562
پاسا,2020-04-20,16911,16253,0.038909585474607676,658
پاسا,2020-04-21,17188,16911,0.016115894809395164,277
پاسا,2020-04-27,17432,17188,0.013997246442519661,244
پاسا,2020-04-28,17329,17432,0.005943793640374875,103
پاسا,2020-04-29,17734,17329,0.02283748731121927,405
پاسا,2020-05-02,18461,17734,0.0393803152570619,727
پاسا,2020-05-03,19371,18461,0.04697744050142081,910
پاسا,2020-05-04,20086,19371,0.03559693318552241,715
پاسا,2020-05-05,21049,20086,0.045750391940436584,963
پاسا,2020-05-06,22101,21049,0.04759965612200354,1052
پاسا,2020-05-09,23191,22101,0.0470009917620197,1090
پاسا,2020-05-10,23376,23191,0.007914099931215174,185
پاسا,2020-05-11,23895,23376,0.02172002510894664,519
پاسا,2020-05-12,23970,23895,0.00312891113879312,75
پاسا,2020-05-13,24911,23970,0.037774477137097084,941
پاسا,2020-05-16,24183,24911,0.030103791918698927,728
پاسا,2020-05-17,23241,24183,0.04053181876681159,942
پاسا,2020-05-18,24250,23241,0.041608247420964604,1009
پاسا,2020-05-19,25443,24250,0.04688912470829348,1193
پاسا,2020-05-20,26680,25443,0.04636431783934167,1237
پاسا,2020-05-26,25575,26680,0.04320625610779252,1105
پاسا,2020-05-27,24425,25575,0.047082906855800084,1150
پاسا,2020-05-30,24531,24425,0.004321063144416409,106
پاسا,2020-06-01,24700,24531,0.0068421052628808866,169
پاسا,2020-06-02,24018,24700,0.028395370137880117,682
پاسا,2020-06-06,25025,24018,0.040239760238152254,1007
پاسا,2020-06-07,25539,25025,0.02012608167821269,514
پاسا,2020-06-08,26812,25539,0.04747874086052966,1273
پاسا,2020-06-09,27982,26812,0.04181259380881236,1170
پاسا,2020-06-10,28594,27982,0.021403091556920925,612
پاسا,2020-06-13,29110,28594,0.017725867398910137,516
پاسا,2020-06-14,29890,29110,0.02609568417443641,780
پاسا,2020-06-15,30730,29890,0.02733485193532916,840
پاسا,2020-06-16,31450,30730,0.022893481716283196,720
پاسا,2020-06-20,32750,31450,0.03969465648733757,1300
پاسا,2020-06-21,34270,32750,0.044353662093832694,1520
پاسا,2020-06-22,33590,34270,0.020244120273288355,680
پاسا,2020-06-23,34890,33590,0.03725995987282144,1300
پاسا,2020-06-27,35360,34890,0.013291855203244008,470
پاسا,2020-06-28,34110,35360,0.036646144824489996,1250
پاسا,2020-06-29,33350,34110,0.02278860569646811,760
پاسا,2020-06-30,32950,33350,0.012139605462454033,400
پاسا,2020-07-01,31680,32950,0.04008838383711842,1270
پاسا,2020-07-04,30380,31680,0.042791310071007525,1300
پاسا,2020-07-05,30490,30380,0.0036077402425842,110
پاسا,2020-07-06,32010,30490,0.04748516088573929,1520
پاسا,2020-07-07,31050,32010,0.03091787439513952,960
پاسا,2020-07-08,29620,31050,0.04827819041025394,1430
پاسا,2020-07-11,28290,29620,0.04701307882477861,1330
پاسا,2020-07-12,29610,28290,0.04457953393973051,1320
پاسا,2020-07-13,28530,29610,0.037854889588578515,1080
پاسا,2020-07-14,27230,28530,0.04774146162145643,1300
پاسا,2020-07-15,27360,27230,0.004751461988130429,130
پاسا,2020-07-18,28020,27360,0.023554603853549086,660
پاسا,2020-07-19,29340,28020,0.04498977504959135,1320
پاسا,2020-07-20,28620,29340,0.025157232703523505,720
پاسا,2020-07-21,27230,28620,0.051046639733711104,1390
پاسا,2020-07-22,27960,27230,0.026108726751569788,730
پاسا,2020-07-25,28660,27960,0.024424284716523924,700
پاسا,2020-07-26,29590,28660,0.03142953700468302,930
پاسا,2020-07-27,30550,29590,0.031423895252653884,960
پاسا,2020-07-28,31760,30550,0.03809823677461907,1210
پاسا,2020-07-29,33340,31760,0.04739052189419944,1580
پاسا,2020-08-01,33940,33340,0.01767825574491225,600
پاسا,2020-08-02,32940,33940,0.030358227078616934,1000
پاسا,2020-08-03,31420,32940,0.048376830043017925,1520
پاسا,2020-08-04,30470,31420,0.03117820807249169,950
پاسا,2020-08-05,31930,30470,0.04572502348744989,1460
پاسا,2020-08-09,30790,31930,0.03702500811831682,1140
پاسا,2020-08-10,29850,30790,0.03149078726862677,940
پاسا,2020-08-11,29650,29850,0.006745362563010274,200
پاسا,2020-08-12,28730,29650,0.03202227636505318,920
پاسا,2020-08-15,28060,28730,0.023877405558664383,670
پاسا,2020-08-16,27620,28060,0.01593048515510751,440
پاسا,2020-08-17,26620,27620,0.0375657400436677,1000
پاسا,2020-08-18,27540,26620,0.03340595497336943,920
پاسا,2020-08-19,27280,27540,0.009530791788506935,260
پاسا,2020-08-22,26440,27280,0.03177004538457753,840
پاسا,2020-08-23,26240,26440,0.007621951219221724,200
پاسا,2020-08-24,26150,26240,0.003441682600250796,90
پاسا,2020-08-25,25820,26150,0.012780790084710272,330
پاسا,2020-08-26,26850,25820,0.038361266292798464,1030
پاسا,2020-08-31,26170,26850,0.025983951088040354,680
پاسا,2020-09-01,26130,26170,0.0015308075008981703,40
پاسا,2020-09-02,26060,26130,0.0026861089791755137,70
پاسا,2020-09-05,25910,26060,0.005789270551687022,150
پاسا,2020-09-06,25890,25910,7.724990343463692e-4,20
پاسا,2020-09-07,25890,25890,0,0
پاسا,2020-09-08,25880,25890,3.8639876350902633e-4,10
پاسا,2020-09-09,25840,25880,0.0015479876160391646,40
وملي,2018-02-13,13499,13556,0.004222535002279981,57
وملي,2018-02-14,13502,13499,2.2218930527164943e-4,3
وملي,2018-02-17,13563,13502,0.004497530044643697,61
وملي,2018-02-18,13563,13563,0,0
وملي,2018-02-19,13243,13563,0.024163709127526713,320
وملي,2018-02-25,13244,13243,7.550588945367669e-5,1
وملي,2018-02-26,13246,13244,1.5098897779322143e-4,2
وملي,2018-02-27,13246,13246,0,0
وملي,2018-02-28,13282,13246,0.0027104351752213194,36
وملي,2018-03-03,13348,13282,0.004944560982548355,66
وملي,2018-03-04,13348,13348,0,0
وملي,2018-03-05,13367,13348,0.0014214109372767702,19
وملي,2018-03-06,13379,13367,8.969280214592325e-4,12
وملي,2018-03-07,13380,13379,7.47384155400046e-5,1
وملي,2018-03-10,13393,13380,9.706563129268531e-4,13
وملي,2018-03-11,13393,13393,0,0
وملي,2018-03-12,13395,13393,1.493094438111751e-4,2
وملي,2018-03-13,13415,13395,0.001490868430749842,20
وملي,2018-03-14,13417,13415,1.4906461950144856e-4,2
وملي,2018-04-04,13416,13417,7.453786522998376e-5,1
وملي,2018-04-07,13416,13416,0,0
وملي,2018-04-09,13416,13416,0,0
وملي,2018-04-10,13416,13416,0,0
وملي,2018-04-11,13416,13416,0,0
وملي,2018-04-17,13416,13416,0,0
وملي,2018-05-23,12746,13416,0.052565510744346025,670
وملي,2018-05-26,12745,12746,7.846214201032073e-5,1
وملي,2018-05-27,12744,12745,7.846829880112458e-5,1
وملي,2018-05-28,12743,12744,7.847445655823005e-5,1
وملي,2018-05-29,12740,12743,2.354788068888949e-4,3
وملي,2018-05-30,12737,12740,2.3553427021782725e-4,3
وملي,2018-06-02,12725,12737,9.43025540200941e-4,12
وملي,2018-06-03,12740,12725,0.0011773940344444746,15
وملي,2018-06-09,13009,12740,0.020677992157684833,269
وملي,2018-06-10,13012,13009,2.3055640945046445e-4,3
وملي,2018-06-11,13373,13012,0.026994690792866618,361
وملي,2018-06-12,13374,13373,7.477194556043279e-5,1
وملي,2018-06-17,13382,13374,5.978179643851578e-4,8
وملي,2018-06-18,13468,13382,0.006385506385032261,86
وملي,2018-06-19,13473,13468,3.7111259553394843e-4,5
وملي,2018-06-20,13493,13473,0.0014822500554745237,20
وملي,2018-06-24,13494,13493,7.410701051770364e-5,1
وملي,2018-06-26,13494,13494,0,0
وملي,2018-06-27,13495,13494,7.410151907565013e-5,1
وملي,2018-06-30,13497,13495,1.4818107726545298e-4,2
وملي,2018-07-01,13497,13497,0,0
وملي,2018-07-02,13501,13497,2.9627435002619994e-4,4
وملي,2018-07-03,13501,13501,0,0
وملي,2018-07-04,13501,13501,0,0
وملي,2018-07-07,13381,13501,0.008967939615203053,120
وملي,2018-07-08,13386,13381,3.7352457788932284e-4,5
وملي,2018-07-10,13386,13386,0,0
وملي,2018-07-11,13385,13386,7.471049681922223e-5,1
وملي,2018-07-14,13383,13385,1.4944332360835065e-4,2
وملي,2018-07-15,12937,13383,0.03447476230698966,446
وملي,2018-07-16,13075,12937,0.010554493307032162,138
وملي,2018-07-17,13343,13075,0.02008543805590306,268
وملي,2018-07-25,13342,13343,7.495128166129881e-5,1
وملي,2018-07-28,13341,13342,7.495689977700645e-5,1
وملي,2018-08-04,13417,13341,0.005664455541055045,76
وملي,2018-08-05,13480,13417,0.004673590504104333,63
وملي,2018-08-06,13474,13480,4.4530206319984397e-4,6
وملي,2018-08-07,13564,13474,0.006635210851766793,90
وملي,2018-08-08,13558,13564,4.4254314792428507e-4,6
وملي,2018-08-11,13557,13558,7.37626318452635e-5,1
وملي,2018-08-12,13553,13557,2.9513760788791134e-4,4
وملي,2018-08-13,13777,13553,0.016258982360727373,224
وملي,2018-08-14,13776,13777,7.259001160913254e-5,1
وملي,2018-08-15,13776,13776,0,0
وملي,2018-08-18,13777,13776,7.258474268181863e-5,1
وملي,2018-08-19,14396,13777,0.042998055012295214,619
وملي,2018-08-20,14393,14396,2.0843465572094528e-4,3
وملي,2018-08-21,14394,14393,6.94733916861558e-5,1
وملي,2018-08-27,14395,14394,6.946856546929707e-5,1
وملي,2018-08-29,14395,14395,0,0
وملي,2018-09-02,14394,14395,6.94733916861558e-5,1
وملي,2018-09-04,14394,14394,0,0
وملي,2018-09-08,14397,14394,2.0837674514076704e-4,3
وملي,2018-09-09,14400,14397,2.0833333331886573e-4,3
وملي,2018-09-10,14404,14400,2.777006386921896e-4,4
وملي,2018-09-11,14414,14404,6.937699458378125e-4,10
وملي,2018-09-12,14417,14414,2.0808767425899372e-4,3
وملي,2018-09-15,14427,14417,6.931447979002464e-4,10
وملي,2018-09-17,14428,14427,6.930967562591422e-5,1
وملي,2018-09-18,14435,14428,4.849324558029143e-4,7
وملي,2018-09-22,14462,14435,0.0018669616925828404,27
وملي,2018-09-23,15000,14462,0.03586666666427556,538
وملي,2018-09-24,15034,15000,0.002261540508031027,34
وملي,2018-09-25,15101,15034,0.004436792265119079,67
وملي,2018-09-26,15186,15101,0.0055972606344266256,85
وملي,2018-09-29,15186,15186,0,0
وملي,2018-09-30,15190,15186,2.6333113888983995e-4,4
وملي,2018-10-01,15343,15190,0.009971974189534513,153
وملي,2018-10-02,15437,15343,0.006089266048708346,94
وملي,2018-10-03,15631,15437,0.012411234085316919,194
وملي,2018-10-06,15665,15631,0.0021704436640810443,34
وملي,2018-10-07,16344,15665,0.041544297599024456,679
وملي,2018-10-08,16229,16344,0.0070860804727903084,115
وملي,2018-10-09,16085,16229,0.00895244016108471,144
وملي,2018-10-10,15903,16085,0.011444381562507428,182
وملي,2018-10-14,15900,15903,1.8867924527115224e-4,3
وملي,2018-10-15,15823,15900,0.004866333817552529,77
وملي,2018-10-16,15813,15823,6.323910705980907e-4,10
وملي,2018-10-17,15790,15813,0.0014566181126373264,23
وملي,2018-10-20,15790,15790,0,0
وملي,2018-10-22,15786,15790,2.533890789146466e-4,4
وملي,2018-10-24,15777,15786,5.704506559820973e-4,9
وملي,2018-10-31,15776,15777,6.33874239310733e-5,1
وملي,2018-11-03,15771,15776,3.170376006393356e-4,5
وملي,2018-11-04,15763,15771,5.075176044847099e-4,8
وملي,2018-11-05,15757,15763,3.8078314397532633e-4,6
وملي,2018-11-10,15752,15757,3.1742001013728924e-4,5
وملي,2018-11-12,15676,15752,0.004848175554679243,76
وملي,2018-11-20,15667,15676,5.744558626045537e-4,9
وملي,2018-11-21,15640,15667,0.0017263427108870624,27
وملي,2018-11-26,15624,15640,0.001024065540129028,16
وملي,2018-11-27,15564,15624,0.0038550501154038133,60
وملي,2018-11-28,15524,15564,0.002576655500993516,40
وملي,2018-12-05,15519,15524,3.221857078212394e-4,5
وملي,2018-12-08,15517,15519,1.2889089385004248e-4,2
وملي,2018-12-10,15506,15517,7.094028117690312e-4,11
وملي,2018-12-11,15505,15506,6.44953240848439e-5,1
وملي,2018-12-12,15440,15505,0.004209844559312834,65
وملي,2018-12-15,15440,15440,0,0
وملي,2018-12-16,15432,15440,5.18403317747641e-4,8
وملي,2018-12-17,15431,15432,6.480461408432347e-5,1
وملي,2018-12-18,15429,15431,1.2962602889820299e-4,2
وملي,2018-12-22,15127,15429,0.0199643022397062,302
وملي,2018-12-24,15108,15127,0.0012576118611823132,19
وملي,2018-12-25,15105,15108,1.9860973186371336e-4,3
وملي,2018-12-26,14874,15105,0.015530455827919157,231
وملي,2018-12-29,14873,14874,6.723593087694239e-5,1
وملي,2018-12-30,14843,14873,0.002021154752946092,30
وملي,2018-12-31,14837,14843,4.0439441932975704e-4,6
وملي,2019-01-01,14837,14837,0,0
وملي,2019-01-02,14579,14837,0.017696687014356494,258
وملي,2019-01-05,14521,14579,0.003994215274155071,58
وملي,2019-01-06,14468,14521,0.0036632568424341126,53
وملي,2019-01-07,14467,14468,6.91228312663909e-5,1
وملي,2019-01-08,14465,14467,1.3826477703848843e-4,2
وملي,2019-01-15,14465,14465,0,0
وملي,2019-01-16,14460,14465,3.4578146608950334e-4,5
وملي,2019-01-19,14456,14460,2.7670171553149546e-4,4
وملي,2019-01-20,14456,14456,0,0
وملي,2019-01-21,14456,14456,0,0
وملي,2019-01-23,14448,14456,5.537098559971131e-4,8
وملي,2019-01-26,14441,14448,4.84730974275692e-4,7
وملي,2019-01-29,14412,14441,0.0020122120453780036,29
وملي,2019-02-02,14407,14412,3.470535156280243e-4,5
وملي,2019-02-06,14405,14407,1.388406803096952e-4,2
وملي,2019-02-10,14404,14405,6.94251596730474e-5,1
وملي,2019-02-13,14354,14404,0.003483349588722074,50
وملي,2019-02-16,14351,14354,2.0904466586237582e-4,3
وملي,2019-02-17,14346,14351,3.485292067232309e-4,5
وملي,2019-02-18,14335,14346,7.673526333611892e-4,11
وملي,2019-02-19,14332,14335,2.0932179736189493e-4,3
وملي,2019-02-20,14321,14332,7.681027860646531e-4,11
وملي,2019-02-23,14294,14321,0.0018889044352953053,27
وملي,2019-02-24,14291,14294,2.0992232872367767e-4,3
وملي,2019-02-27,14289,14291,1.3996780739450153e-4,2
وملي,2019-03-02,14283,14289,4.2007981513547015e-4,6
وملي,2019-03-03,14265,14283,0.0012618296529083891,18
وملي,2019-03-04,14192,14265,0.005143742953414336,73
وملي,2019-03-06,14191,14192,7.046719751458902e-5,1
وملي,2019-03-09,14189,14191,1.409542603325848e-4,2
وملي,2019-03-10,14177,14189,8.464414191404076e-4,12
وملي,2019-03-11,14300,14177,0.008601398600797104,123
وملي,2019-03-12,14806,14300,0.03417533432161452,506
وملي,2019-03-13,14818,14806,8.098258873795502e-4,12
وملي,2019-03-16,14913,14818,0.006370280962491096,95
وملي,2019-03-17,15014,14913,0.006727054748452974,101
وملي,2019-03-18,15000,15014,9.333333332711111e-4,14
وملي,2019-03-19,15000,15000,0,0
وملي,2019-03-25,15119,15000,0.007870890931419346,119
وملي,2019-03-26,15168,15119,0.0032304852318545303,49
وملي,2019-03-27,15303,15168,0.008821799646551538,135
وملي,2019-03-30,15310,15303,4.57217504868895e-4,7
وملي,2019-03-31,15377,15310,0.004357156792328987,67
وملي,2019-04-06,15429,15377,0.003370276751353278,52
وملي,2019-04-07,15456,15429,0.0017468944098248645,27
وملي,2019-04-08,15459,15456,1.940617116117432e-4,3
وملي,2019-04-09,15468,15459,5.8184639251475e-4,9
وملي,2019-04-10,15495,15468,0.001742497579752017,27
وملي,2019-04-13,15522,15495,0.001739466563475102,27
وملي,2019-04-14,15551,15522,0.0018648318434914262,29
وملي,2019-04-15,15553,15551,1.2859255448282694e-4,2
وملي,2019-04-16,15570,15553,0.0010918432883049555,17
وملي,2019-04-17,15571,15570,6.422195105874882e-5,1
وملي,2019-04-20,15588,15571,0.001090582499288518,17
وملي,2019-04-22,15598,15588,6.411078342966336e-4,10
وملي,2019-04-23,15637,15598,0.0024940845429114226,39
وملي,2019-04-28,15638,15637,6.39467962614179e-5,1
وملي,2019-04-29,15640,15638,1.278772378434861e-4,2
وملي,2019-04-30,15643,15640,1.9177907049851186e-4,3
وملي,2019-05-01,15647,15643,2.556400587808756e-4,4
وملي,2019-05-04,15647,15647,0,0
وملي,2019-05-05,15666,15647,0.001212817566627549,19
وملي,2019-05-06,15668,15666,1.2764871073987435e-4,2
وملي,2019-05-07,15672,15668,2.5523226134154973e-4,4
وملي,2019-05-08,15672,15672,0,0
وملي,2019-05-11,15696,15672,0.0015290519876701675,24
وملي,2019-05-12,16480,15696,0.04757281553109388,784
وملي,2019-05-13,16480,16480,0,0
وملي,2019-05-14,16481,16480,6.0675929854943516e-5,1
وملي,2019-05-15,16489,16481,4.851719327742633e-4,8
وملي,2019-05-18,16489,16489,0,0
وملي,2019-05-19,16490,16489,6.0642813822884e-5,1
وملي,2019-05-20,16490,16490,0,0
وملي,2019-05-21,16490,16490,0,0
وملي,2019-05-22,16490,16490,0,0
وملي,2019-05-25,16490,16490,0,0
وملي,2019-05-26,16490,16490,0,0
وملي,2019-05-28,17314,16490,0.047591544412175606,824
وملي,2019-05-29,17533,17314,0.01249073176224886,219
وملي,2019-06-01,17980,17533,0.02486095661708226,447
وملي,2019-06-02,18207,17980,0.012467732190230806,227
وملي,2019-06-03,18439,18207,0.012582027224221377,232
وملي,2019-06-08,18690,18439,0.013429641518810613,251
وملي,2019-06-09,18931,18690,0.012730442131280415,241
وملي,2019-06-10,19184,18931,0.013188073393807962,253
وملي,2019-06-11,19428,19184,0.0125591929167923,244
وملي,2019-06-12,19679,19428,0.012754713145345053,251
وملي,2019-06-15,20027,19679,0.017376541667879535,348
وملي,2019-06-16,21028,20027,0.04760319573675085,1001
وملي,2019-06-17,21294,21028,0.012491781721964319,266
وملي,2019-06-25,22356,21294,0.04750402576277044,1062
وملي,2019-06-26,22583,22356,0.010051808882342833,227
وملي,2019-06-30,23158,22583,0.024829432592416035,575
وملي,2019-07-01,23392,23158,0.010003419972212576,234
وملي,2019-07-02,23689,23392,0.012537464645508993,297
وملي,2019-07-03,23988,23689,0.012464565615621787,299
وملي,2019-07-06,24291,23988,0.012473755711478582,303
وملي,2019-07-07,25505,24291,0.04759851009419335,1214
وملي,2019-07-08,26730,25505,0.04582865693805355,1225
وملي,2019-07-09,28016,26730,0.04590234151749349,1286
وملي,2019-07-10,29367,28016,0.04600401811400538,1351
وملي,2019-07-13,41617,29367,0.29435086622547635,12250
وملي,2019-07-14,43697,41617,0.04760052177386089,2080
وملي,2019-07-15,45881,43697,0.04760140363009521,2184
وملي,2019-07-16,48175,45881,0.04761805915832656,2294
وملي,2019-07-17,50583,48175,0.0476049265554118,2408
وملي,2019-07-20,52708,50583,0.040316460498590036,2125
وملي,2019-07-21,55343,52708,0.04761216413913933,2635
وملي,2019-07-22,58110,55343,0.04761658922650806,2767
وملي,2019-07-23,61015,58110,0.04761124313615322,2905
وملي,2019-07-24,64065,61015,0.047607898227618704,3050
وملي,2019-07-29,70496,64065,0.09122503404319075,6431
وملي,2019-07-30,74020,70496,0.047608754390062034,3524
وملي,2019-07-31,77721,74020,0.04761904761843493,3701
وملي,2019-08-03,80474,77721,0.034209806893727046,2753
وملي,2019-08-04,78025,80474,0.03138737584067431,2449
وملي,2019-08-05,75751,78025,0.03001940568401712,2274
وملي,2019-08-06,72780,75751,0.040821654300071154,2971
وملي,2019-08-07,72616,72780,0.002258455436787231,164
وملي,2019-08-10,70463,72616,0.030555043071817056,2153
وملي,2019-08-11,68919,70463,0.022403110897975843,1544
وملي,2019-08-13,67634,68919,0.018999319868424177,1285
وملي,2019-08-14,66711,67634,0.0138357991933289,923
وملي,2019-08-17,65399,66711,0.020061468829491867,1312
وملي,2019-08-18,68475,65399,0.04492150419795661,3076
وملي,2019-08-19,71897,68475,0.04759586630808524,3422
وملي,2019-08-21,73224,71897,0.01812247350570684,1327
وملي,2019-08-24,70697,73224,0.035744090979309674,2527
وملي,2019-08-25,67544,70697,0.04668068222126791,3153
وملي,2019-08-26,68028,67544,0.007114717469172772,484
وملي,2019-08-27,66206,68028,0.027520164335143038,1822
وملي,2019-08-28,65293,66206,0.013983122233409659,913
وملي,2019-08-31,65341,65293,7.34607673578081e-4,48
وملي,2019-09-01,65536,65341,0.0029754638671420984,195
وملي,2019-09-02,65069,65536,0.007176996726441516,467
وملي,2019-09-03,67792,65069,0.040166981354139625,2723
وملي,2019-09-04,69856,67792,0.029546495647767602,2064
وملي,2019-09-07,71036,69856,0.01661129568082928,1180
وملي,2019-09-08,71637,71036,0.008389519382324923,601
وملي,2019-09-11,74942,71637,0.044100771262521675,3305
وملي,2019-09-14,74829,74942,0.001510109716800838,113
وملي,2019-09-15,72776,74829,0.028209849400513774,2053
وملي,2019-09-16,72518,72776,0.0035577373892887597,258
وملي,2019-09-17,71457,72518,0.014848090459789132,1061
وملي,2019-09-18,69325,71457,0.030753696357291693,2132
وملي,2019-09-21,68322,69325,0.01468048359218582,1003
وملي,2019-09-22,68967,68322,0.009352298925437496,645
وملي,2019-09-23,69276,68967,0.004460419192729655,309
وملي,2019-09-24,68845,69276,0.006260440119017207,431
وملي,2019-09-25,68428,68845,0.006093996609485971,417
وملي,2019-09-28,68986,68428,0.008088597686369865,558
وملي,2019-09-29,69602,68986,0.008850320392964997,616
وملي,2019-09-30,69539,69602,9.059664360875773e-4,63
وملي,2019-10-01,68851,69539,0.009992592700033514,688
وملي,2019-10-02,68648,68851,0.002957114555370046,203
وملي,2019-10-05,70325,68648,0.023846427301473926,1677
وملي,2019-10-06,70545,70325,0.0031185767949093693,220
وملي,2019-10-07,70236,70545,0.004399453271763776,309
وملي,2019-10-08,66973,70236,0.048721126423353876,3263
وملي,2019-10-09,66499,66973,0.007127926735633199,474
وملي,2019-10-12,67808,66499,0.01930450684256571,1309
وملي,2019-10-13,67925,67808,0.0017224880382521535,117
وملي,2019-10-14,67596,67925,0.004867151902407434,329
وملي,2019-10-15,66508,67596,0.016358934263301275,1088
وملي,2019-10-16,66352,66508,0.0023510971786479522,156
وملي,2019-10-20,65089,66352,0.019404200402227654,1263
وملي,2019-10-21,61838,65089,0.052572851643769646,3251
وملي,2019-10-22,61866,61838,4.525910839483304e-4,28
وملي,2019-10-23,61038,61866,0.013565319964389965,828
وملي,2019-10-26,57995,61038,0.052470040519829814,3043
وملي,2019-10-28,58188,57995,0.0033168350862150817,193
وملي,2019-10-30,58677,58188,0.008333759394510051,489
وملي,2019-11-02,61610,58677,0.04760590813102409,2933
وملي,2019-11-03,62642,61610,0.016474569777202602,1032
وملي,2019-11-04,63088,62642,0.0070694902357489615,446
وملي,2019-11-05,64312,63088,0.019032217937258487,1224
وملي,2019-11-09,64638,64312,0.005043472879652163,326
وملي,2019-11-10,62773,64638,0.02971022573352062,1865
وملي,2019-11-11,61582,62773,0.01934006690235231,1191
وملي,2019-11-12,60612,61582,0.016003431663432925,970
وملي,2019-11-13,62046,60612,0.02311188473031119,1434
وملي,2019-11-16,63119,62046,0.01699963560865984,1073
وملي,2019-11-17,65442,63119,0.03549708138450083,2323
وملي,2019-11-18,68703,65442,0.04746517619248847,3261
وملي,2019-11-19,70731,68703,0.02867201085763425,2028
وملي,2019-11-20,71770,70731,0.014476800891535786,1039
وملي,2019-11-23,72435,71770,0.00918064471582549,665
وملي,2019-11-24,72681,72435,0.0033846534857337593,246
وملي,2019-11-25,76315,72681,0.047618423638241265,3634
وملي,2019-11-26,79853,76315,0.04430641303339504,3538
وملي,2019-11-27,83390,79853,0.042415157692260286,3537
وملي,2019-11-30,87495,83390,0.04691696668327428,4105
وملي,2019-12-01,84149,87495,0.03976280169651734,3346
وملي,2019-12-02,88298,84149,0.046988606762927945,4149
وملي,2019-12-03,91887,88298,0.03905884401450631,3589
وملي,2019-12-08,89991,91887,0.02106877354378695,1896
وملي,2019-12-09,86779,89991,0.03701356318882433,3212
وملي,2019-12-10,83278,86779,0.04203991450272533,3501
وملي,2019-12-11,87232,83278,0.0453274027874481,3954
وملي,2019-12-14,87688,87232,0.0052002554510856645,456
وملي,2019-12-15,84755,87688,0.03460562798614117,2933
وملي,2019-12-16,88585,84755,0.04323531071803088,3830
وملي,2019-12-17,92845,88585,0.045882923150994855,4260
وملي,2019-12-18,92803,92845,4.525715763450258e-4,42
وملي,2019-12-21,91279,92803,0.01669606371655369,1524
وملي,2019-12-22,90003,91279,0.014177305200780227,1276
وملي,2019-12-23,86120,90003,0.04508824895442304,3883
وملي,2019-12-24,89995,86120,0.04305794766328065,3875
وملي,2019-12-25,90510,89995,0.005689979007781572,515
وملي,2019-12-28,91065,90510,0.0060945478503695765,555
وملي,2019-12-29,91182,91065,0.0012831479897207438,117
وملي,2019-12-30,91188,91182,6.579813133234858e-5,6
وملي,2019-12-31,88376,91188,0.031818593282884285,2812
وملي,2020-01-01,87289,88376,0.01245288638874941,1087
وملي,2020-01-04,86694,87289,0.006863220061286097,595
وملي,2020-01-05,82435,86694,0.05166494814033281,4259
وملي,2020-01-07,78381,82435,0.051721718272901326,4054
وملي,2020-01-08,77287,78381,0.014155032540865153,1094
وملي,2020-01-11,77288,77287,1.2938619190392577e-5,1
وملي,2020-01-12,78833,77288,0.01959839153629066,1545
وملي,2020-01-13,80566,78833,0.021510314524470494,1733
وملي,2020-01-14,84575,80566,0.04740171445406561,4009
وملي,2020-01-15,86344,84575,0.02048781617691458,1769
وملي,2020-01-18,88078,86344,0.019687095528739446,1734
وملي,2020-01-19,87386,88078,0.007918888609068742,692
وملي,2020-01-20,85935,87386,0.016884854831944088,1451
وملي,2020-01-21,88098,85935,0.024552203227944425,2163
وملي,2020-01-22,89960,88098,0.020698088038898423,1862
وملي,2020-01-25,90477,89960,0.005714159399563269,517
وملي,2020-01-26,88071,90477,0.027318867731406266,2406
وملي,2020-01-27,88273,88071,0.0022883554427481976,202
وملي,2020-01-28,92335,88273,0.04399198570375273,4062
وملي,2020-02-01,96246,92335,0.04063545497952502,3911
وملي,2020-02-02,95347,96246,0.009428718260570037,899
وملي,2020-02-03,95273,95347,7.767153338219988e-4,74
وملي,2020-02-04,92904,95273,0.02549944028216762,2369
وملي,2020-02-05,92457,92904,0.0048346799052009625,447
وملي,2020-02-08,93044,92457,0.006308843127914655,587
وملي,2020-02-09,92197,93044,0.009186849897402444,847
وملي,2020-02-10,90676,92197,0.016774008557757576,1521
وملي,2020-02-12,89955,90676,0.008015118670357233,721
وملي,2020-02-15,86867,89955,0.03554859728049146,3088
وملي,2020-02-16,86345,86867,0.006045515084764081,522
وملي,2020-02-17,85121,86345,0.014379530315499354,1224
وملي,2020-02-18,86227,85121,0.012826608834670968,1106
وملي,2020-02-19,90330,86227,0.045422340307257586,4103
وملي,2020-02-22,92670,90330,0.025250890255473717,2340
وملي,2020-02-23,93151,92670,0.005163659005215579,481
وملي,2020-02-24,88734,93151,0.04977798814378054,4417
وملي,2020-02-25,89302,88734,0.006360439855699084,568
وملي,2020-02-26,89013,89302,0.003246716771671029,289
وملي,2020-02-29,87466,89013,0.01768687261315612,1547
وملي,2020-03-01,87648,87466,0.0020764877692351627,182
وملي,2020-03-02,87548,87648,0.001142230547800724,100
وملي,2020-03-03,88103,87548,0.006299444967750254,555
وملي,2020-03-04,89304,88103,0.013448445758158107,1201
وملي,2020-03-07,89355,89304,5.707570924898354e-4,51
وملي,2020-03-09,88856,89355,0.005615827856243633,499
وملي,2020-03-10,88658,88856,0.0022333009993206108,198
وملي,2020-03-11,88567,88658,0.0010274707283635274,91
وملي,2020-03-14,87932,88567,0.007221489332584026,635
وملي,2020-03-15,87642,87932,0.003308915816579849,290
وملي,2020-03-16,87594,87642,5.4798273853748e-4,48
وملي,2020-03-17,87460,87594,0.001532128973227394,134
وملي,2020-03-18,87337,87460,0.00140833781786175,123
وملي,2020-03-24,87057,87337,0.003216283584281376,280
وملي,2020-03-25,87126,87057,7.919564768175751e-4,69
وملي,2020-03-28,87826,87126,0.007970304921003231,700
وملي,2020-03-29,88036,87826,0.002385387795874581,210
وملي,2020-03-30,89836,88036,0.020036510975332423,1800
وملي,2020-04-04,91610,89836,0.019364698176843526,1774
وملي,2020-04-05,91762,91610,0.0016564591006990208,152
وملي,2020-04-06,94836,91762,0.03241385127976282,3074
وملي,2020-04-07,99577,94836,0.04761139620547304,4741
وملي,2020-04-08,104555,99577,0.0476113050543005,4978
وملي,2020-04-11,107160,104555,0.024309443822094913,2605
وملي,2020-04-12,112518,107160,0.047619047618624406,5358
وملي,2020-04-13,117603,112518,0.04323869289011982,5085
وملي,2020-04-14,122622,117603,0.040930664970063035,5019
وملي,2020-04-15,128738,122622,0.047507340489618397,6116
وملي,2020-04-18,130707,128738,0.01506422762350093,1969
وملي,2020-04-21,143286,130707,0.08778945605231642,12579
وملي,2020-04-22,150450,143286,0.04761714855402049,7164
وملي,2020-04-25,157556,150450,0.04510142425521654,7106
وملي,2020-04-26,160294,157556,0.017081113453921663,2738
وملي,2020-04-27,154749,160294,0.03583221862476764,5545
وملي,2020-04-28,162486,154749,0.047616410028878696,7737
وملي,2020-04-29,170518,162486,0.04710353159169645,8032
وملي,2020-05-02,179043,170518,0.04761426026123549,8525
وملي,2020-05-03,187995,179043,0.0476182877201648,8952
وملي,2020-05-04,191952,187995,0.020614528632050644,3957
وملي,2020-05-05,186292,191952,0.03038241040930162,5660
وملي,2020-05-06,180539,186292,0.0318656910693431,5753
وملي,2020-05-09,186738,180539,0.03319624286415622,6199
وملي,2020-05-10,178630,186738,0.0453899121085742,8108
وملي,2020-05-11,171130,178630,0.04382633085932434,7500
وملي,2020-05-12,163535,171130,0.04644265753480024,7595
وملي,2020-05-13,171166,163535,0.0445824521222405,7631
وملي,2020-05-16,179004,171166,0.043786731022525824,7838
وملي,2020-05-17,185562,179004,0.03534128754790668,6558
وملي,2020-05-18,194840,185562,0.04761855881724687,9278
وملي,2020-05-19,204519,194840,0.04732567634279785,9679
وملي,2020-05-20,209369,204519,0.02316484293270176,4850
وملي,2020-05-23,200082,209369,0.046415969452292476,9287
وملي,2020-05-26,190089,200082,0.05257011189467791,9993
وملي,2020-05-27,181233,190089,0.04886527288049712,8856
وملي,2020-05-30,189953,181233,0.04590609255949679,8720
وملي,2020-05-31,199143,189953,0.046147743078862186,9190
وملي,2020-06-01,209087,199143,0.0475591500186642,9944
وملي,2020-06-02,219541,209087,0.04761752929954943,10454
وملي,2020-06-06,230517,219541,0.04761470954399192,10976
وملي,2020-06-07,242042,230517,0.04761570305960281,11525
وملي,2020-06-08,253880,242042,0.04662832834391591,11838
وملي,2020-06-09,266574,253880,0.04761904761886898,12694
وملي,2020-06-10,270050,266574,0.01287169042765091,3476
وملي,2020-06-13,283030,270050,0.045860862805900925,12980
وملي,2020-06-14,296990,283030,0.04700494966144649,13960
وملي,2020-06-15,311830,296990,0.04759003303066546,14840
وملي,2020-06-22,327420,311830,0.0476146845029393,15590
وملي,2020-06-23,340040,327420,0.03711328079038609,12620
وملي,2020-06-24,357040,340040,0.047613712749138434,17000
وملي,2020-06-27,374890,357040,0.04761396676345698,17850
وملي,2020-06-28,393630,374890,0.04760815994703755,18740
وملي,2020-06-29,413310,393630,0.04761559120261398,19680
وملي,2020-06-30,433970,413310,0.04760697744072722,20660
وملي,2020-07-01,455660,433970,0.04760128165727165,21690
وملي,2020-07-04,463240,455660,0.016363008375752604,7580
وملي,2020-07-05,454480,463240,0.019274775567639336,8760
وملي,2020-07-06,472920,454480,0.03899179565245921,18440
وملي,2020-07-07,450930,472920,0.04876588383995572,21990
وملي,2020-07-08,428880,450930,0.05141298265237033,22050
وملي,2020-07-11,419250,428880,0.02296958855092911,9630
وملي,2020-07-12,440210,419250,0.04761363894494079,20960
وملي,2020-07-13,462220,440210,0.04761801739421138,22010
وملي,2020-07-19,522370,462220,0.11514826655413758,60150
وملي,2020-07-20,548480,522370,0.04760428821461565,26110
وملي,2020-07-21,564750,548480,0.028809207613937477,16270
وملي,2020-07-22,587080,564750,0.038035702118896855,22330
وملي,2020-07-25,616430,587080,0.04761286764101745,29350
وملي,2020-07-26,647250,616430,0.047616840478875835,30820
وملي,2020-07-27,679610,647250,0.04761554420910873,32360
وملي,2020-07-28,713590,679610,0.04761838030234782,33980
وملي,2020-07-29,744430,713590,0.04142766949203897,30840
وملي,2020-08-01,781650,744430,0.0476172199833076,37220
وملي,2020-08-02,795610,781650,0.017546285240233852,13960
وملي,2020-08-22,755830,795610,0.05263088260580735,39780
وملي,2020-08-23,745280,755830,0.014155753542273835,10550
وملي,2020-08-24,737360,745280,0.010741022024505342,7920
وملي,2020-08-25,700500,737360,0.05261955745888277,36860
وملي,2020-08-26,667740,700500,0.04906101177097514,32760
وملي,2020-08-31,656480,667740,0.017152083841065757,11260
وملي,2020-09-01,654040,656480,0.0037306586753046746,2440
وملي,2020-09-02,650640,654040,0.005225624000975615,3400
وملي,2020-09-05,644660,650640,0.009276207613301156,5980
وملي,2020-09-06,640640,644660,0.00627497502496523,4020
وملي,2020-09-07,639140,640640,0.0023469036517784103,1500
وملي,2020-09-08,638360,639140,0.0012218810702405822,780
وملي,2020-09-09,632250,638360,0.009663898774203775,6110
سخوز,2018-01-15,2530,2528,7.905138336796388e-4,2
سخوز,2018-01-16,2530,2530,0,0
سخوز,2018-01-17,2531,2530,3.951007505353217e-4,1
سخوز,2018-01-20,2531,2531,0,0
سخوز,2018-01-21,2528,2531,0.0011867088602900678,3
سخوز,2018-01-22,2522,2528,0.0023790642337910136,6
سخوز,2018-01-23,2521,2522,3.966679887359508e-4,1
سخوز,2018-01-24,2521,2521,0,0
سخوز,2018-01-27,2521,2521,0,0
سخوز,2018-01-28,2520,2521,3.9682539666792643e-4,1
سخوز,2018-01-29,2518,2520,7.942811752206985e-4,2
سخوز,2018-01-30,2514,2518,0.001591089895946265,4
سخوز,2018-01-31,2513,2514,3.979307598894028e-4,1
سخوز,2018-02-03,2512,2513,3.980891718160473e-4,1
سخوز,2018-02-04,2509,2512,0.0011956954957370685,3
سخوز,2018-02-05,2508,2509,3.9872408277562835e-4,1
سخوز,2018-02-06,2506,2508,7.98084596648809e-4,2
سخوز,2018-02-07,2505,2506,3.992015966470253e-4,1
سخوز,2018-02-10,2501,2505,0.0015993602552581527,4
سخوز,2018-02-12,2499,2501,8.003201277309643e-4,2
سخوز,2018-02-13,2497,2499,8.009611530632915e-4,2
سخوز,2018-02-14,2492,2497,0.0020064205449412437,5
سخوز,2018-02-17,2492,2492,0,0
سخوز,2018-02-18,2485,2492,0.0028169014073171424,7
سخوز,2018-02-19,2497,2485,0.004805766918379749,12
سخوز,2018-02-21,2496,2497,4.006410254805124e-4,1
سخوز,2018-02-24,2495,2496,4.008016030457709e-4,1
سخوز,2018-02-25,2487,2495,0.003216726979004131,8
سخوز,2018-02-26,2499,2487,0.004801920766385786,12
سخوز,2018-02-27,2500,2499,3.9999999984e-4,1
سخوز,2018-02-28,2500,2500,0,0
سخوز,2018-03-03,2501,2500,3.998400638145382e-4,1
سخوز,2018-03-04,2509,2501,0.0031885213219655156,8
سخوز,2018-03-05,2509,2509,0,0
سخوز,2018-03-06,2508,2509,3.9872408277562835e-4,1
سخوز,2018-03-10,2508,2508,0,0
سخوز,2018-03-11,2507,2508,3.9888312708460987e-4,1
سخوز,2018-03-12,2507,2507,0,0
سخوز,2018-03-13,2502,2507,0.0019984012781780972,5
سخوز,2018-03-14,2481,2502,0.008464328896225583,21
سخوز,2018-03-17,2476,2481,0.0020193861058080023,5
سخوز,2018-03-18,2481,2476,0.002015316403863234,5
سخوز,2018-03-19,2480,2481,4.032258062890219e-4,1
سخوز,2018-03-26,2480,2480,0,0
سخوز,2018-03-27,2478,2480,8.071025016920491e-4,2
سخوز,2018-03-28,2477,2478,4.037141702043948e-4,1
سخوز,2018-04-03,2476,2477,4.038772211616005e-4,1
سخوز,2018-04-04,2476,2476,0,0
سخوز,2018-04-08,2476,2476,0,0
سخوز,2018-04-09,2440,2476,0.014754098354608976,36
سخوز,2018-04-10,2416,2440,0.009933774830325424,24
سخوز,2018-04-11,2404,2416,0.0049916805303695175,12
سخوز,2018-04-15,2397,2404,0.0029203170617770895,7
سخوز,2018-04-17,2384,2397,0.005453020131940847,13
سخوز,2018-04-18,2383,2384,4.196391101889891e-4,1
سخوز,2018-04-21,2383,2383,0,0
سخوز,2018-04-22,2381,2383,8.399831999832074e-4,2
سخوز,2018-04-23,2367,2381,0.005914659904556544,14
سخوز,2018-04-24,2368,2367,4.222972971189623e-4,1
سخوز,2018-04-25,2367,2368,4.224757074683246e-4,1
سخوز,2018-04-28,2367,2367,0,0
سخوز,2018-04-29,2363,2367,0.0016927634355934137,4
سخوز,2018-04-30,2361,2363,8.470986866382471e-4,2
سخوز,2018-05-01,2357,2361,0.0016970725491314924,4
سخوز,2018-05-05,2352,2357,0.0021258503392322064,5
سخوز,2018-05-06,2351,2352,4.253509143235428e-4,1
سخوز,2018-05-07,2349,2351,8.514261384199974e-4,2
سخوز,2018-05-08,2347,2349,8.521516826364927e-4,2
سخوز,2018-05-09,2345,2347,8.528784644550626e-4,2
سخوز,2018-05-12,2346,2345,4.262574593238459e-4,1
سخوز,2018-05-13,2347,2346,4.2607584131824634e-4,1
سخوز,2018-05-14,2423,2347,0.031366075100550526,76
سخوز,2018-05-15,2417,2423,0.0024824162174255622,6
سخوز,2018-05-16,2421,2417,0.0016522098299660431,4
سخوز,2018-05-19,2420,2421,4.1322314032511443e-4,1
سخوز,2018-05-20,2418,2420,8.27129859045852e-4,2
سخوز,2018-05-21,2418,2418,0,0
سخوز,2018-05-22,2418,2418,0,0
سخوز,2018-05-23,2416,2418,8.278145691937854e-4,2
سخوز,2018-05-30,2165,2416,0.11593533481942941,251
سخوز,2018-06-02,2272,2165,0.04709507040180675,107
سخوز,2018-06-03,2264,2272,0.0035335689030328763,8
سخوز,2018-06-09,2290,2264,0.011353711785435061,26
سخوز,2018-06-10,2268,2290,0.00970017636256606,22
سخوز,2018-06-11,2268,2268,0,0
سخوز,2018-06-12,2298,2268,0.013054830281525313,30
سخوز,2018-06-13,2396,2298,0.04090150248710288,98
سخوز,2018-06-17,2379,2396,0.007145859601872274,17
سخوز,2018-06-18,2376,2379,0.0012626262620948543,3
سخوز,2018-06-19,2388,2376,0.00502512562603638,12
سخوز,2018-06-20,2421,2388,0.013630731097219856,33
سخوز,2018-06-23,2539,2421,0.046474990135299335,118
سخوز,2018-06-24,2665,2539,0.047279549700833194,126
سخوز,2018-06-25,2764,2665,0.035817655558676685,99
سخوز,2018-06-26,2746,2764,0.006554989072631104,18
سخوز,2018-06-27,2727,2746,0.0069673634004520126,19
سخوز,2018-06-30,2732,2727,0.0018301610535028693,5
سخوز,2018-07-01,2709,2732,0.008490217789409296,23
سخوز,2018-07-02,2711,2709,7.377351528079177e-4,2
سخوز,2018-07-04,2707,2711,0.0014776505351024565,4
سخوز,2018-07-07,2706,2707,3.695491499003884e-4,1
سخوز,2018-07-08,2705,2706,3.696857669612992e-4,1
سخوز,2018-07-10,2700,2705,0.0018518518511659809,5
سخوز,2018-07-11,2696,2700,0.0014836795246722257,4
سخوز,2018-07-14,2695,2696,3.710575137769731e-4,1
سخوز,2018-07-15,2713,2695,0.006634721707838289,18
سخوز,2018-07-16,2748,2713,0.012736535657665016,35
سخوز,2018-07-17,2747,2748,3.640334909486591e-4,1
سخوز,2018-07-18,2773,2747,0.009376126934952713,26
سخوز,2018-07-21,2777,2773,0.0014404033124089293,4
سخوز,2018-07-22,2777,2777,0,0
سخوز,2018-07-23,2822,2777,0.015946137485490383,45
سخوز,2018-07-24,2962,2822,0.04726536122644654,140
سخوز,2018-07-25,3100,2962,0.044516129017898025,138
سخوز,2018-07-28,3002,3100,0.03264490338686046,98
سخوز,2018-07-29,2976,3002,0.008736559136849275,26
سخوز,2018-07-30,3115,2976,0.04462279292307455,139
سخوز,2018-07-31,3233,3115,0.03649860809263885,118
سخوز,2018-08-01,3285,3233,0.015829528153476553,52
سخوز,2018-08-04,3242,3285,0.01326341763933886,43
سخوز,2018-08-05,3111,3242,0.04210864672384807,131
سخوز,2018-08-06,3262,3111,0.046290619237801776,151
سخوز,2018-08-07,3291,3262,0.008811911270491671,29
سخوز,2018-08-08,3271,3291,0.00611433812102894,20
سخوز,2018-08-11,3239,3271,0.009879592463760547,32
سخوز,2018-08-12,3233,3239,0.0018558614284392635,6
سخوز,2018-08-13,3289,3233,0.017026451803883718,56
سخوز,2018-08-14,3271,3289,0.005502904308926046,18
سخوز,2018-08-15,3286,3271,0.0045648204490064456,15
سخوز,2018-08-18,3423,3286,0.04002337130002239,137
سخوز,2018-08-19,3436,3423,0.0037834691490734955,13
سخوز,2018-08-20,3497,3436,0.01744352301474306,61
سخوز,2018-08-21,3504,3497,0.001997716894407044,7
سخوز,2018-08-25,3515,3504,0.003129445233818081,11
سخوز,2018-08-26,3645,3515,0.03566529491476947,130
سخوز,2018-08-27,3823,3645,0.04656029295146213,178
سخوز,2018-08-28,3823,3823,0,0
سخوز,2018-08-29,3854,3823,0.008043591072121539,31
سخوز,2018-09-01,4046,3854,0.047454275816249565,192
سخوز,2018-09-02,4084,4046,0.009304603327790255,38
سخوز,2018-09-03,3958,4084,0.0318342597190919,126
سخوز,2018-09-04,4064,3958,0.02608267715893635,106
سخوز,2018-09-05,4065,4064,2.4600245996408304e-4,1
سخوز,2018-09-08,4102,4065,0.009019990246460266,37
سخوز,2018-09-09,4294,4102,0.044713553785581374,192
سخوز,2018-09-10,4345,4294,0.011737629456447034,51
سخوز,2018-09-11,4305,4345,0.009291521484485128,40
سخوز,2018-09-12,4507,4305,0.04481917016977609,202
سخوز,2018-09-15,4731,4507,0.04734728386232355,224
سخوز,2018-09-16,4808,4731,0.016014975038266436,77
سخوز,2018-09-17,4965,4808,0.031621349439754004,157
سخوز,2018-09-18,5207,4965,0.04647589782091878,242
سخوز,2018-09-22,5323,5207,0.02179222242686601,116
سخوز,2018-09-23,5215,5323,0.020709491846460308,108
سخوز,2018-09-24,5222,5215,0.0013404825734698424,7
سخوز,2018-09-25,5215,5222,0.001342281878937242,7
سخوز,2018-09-26,5221,5215,0.001149205132896149,6
سخوز,2018-09-29,5372,5221,0.028108711833933597,151
سخوز,2018-09-30,5640,5372,0.04751773048802877,268
سخوز,2018-10-01,5898,5640,0.043743641905096026,258
سخوز,2018-10-02,5652,5898,0.04352441612818039,246
سخوز,2018-10-03,5595,5652,0.010187667558500863,57
سخوز,2018-10-06,5380,5595,0.039962825271382375,215
سخوز,2018-10-07,5128,5380,0.04914196566904407,252
سخوز,2018-10-08,5038,5128,0.017864231834485066,90
سخوز,2018-10-09,5283,5038,0.04637516561681333,245
سخوز,2018-10-10,5038,5283,0.0486304088827649,245
سخوز,2018-10-13,4796,5038,0.05045871558580927,242
سخوز,2018-10-14,4826,4796,0.006216328220842037,30
سخوز,2018-10-15,5065,4826,0.047186574521779545,239
سخوز,2018-10-16,5110,5065,0.008806262229196426,45
سخوز,2018-10-17,5049,5110,0.012081600314501563,61
سخوز,2018-10-20,5199,5049,0.0288517022448833,150
سخوز,2018-10-21,5164,5199,0.006777691710538789,35
سخوز,2018-10-22,5128,5164,0.00702028080986344,36
سخوز,2018-10-23,5069,5128,0.011639376600584063,59
سخوز,2018-10-24,5006,5069,0.012584898119739332,63
سخوز,2018-10-27,4775,5006,0.048376963340654035,231
سخوز,2018-10-28,4858,4775,0.017085220251732147,83
سخوز,2018-10-29,5043,4858,0.036684513179320935,185
سخوز,2018-10-31,5114,5043,0.013883457173663774,71
سخوز,2018-11-03,5031,5114,0.016497714168853563,83
سخوز,2018-11-04,5004,5031,0.005395683452159136,27
سخوز,2018-11-05,5068,5004,0.01262825571968661,64
سخوز,2018-11-06,5166,5068,0.018970189698224893,98
سخوز,2018-11-10,5187,5166,0.004048582995170892,21
سخوز,2018-11-11,5146,5187,0.007967353282555897,41
سخوز,2018-11-12,5161,5146,0.0029064134851954243,15
سخوز,2018-11-13,5159,5161,3.876720293879294e-4,2
سخوز,2018-11-14,5127,5159,0.006241466743467629,32
سخوز,2018-11-17,5029,5127,0.019486975537982305,98
سخوز,2018-11-18,4923,5029,0.021531586426664313,106
سخوز,2018-11-19,4918,4923,0.0010166734442829048,5
سخوز,2018-11-20,5023,4918,0.020903842321141976,105
سخوز,2018-11-21,4975,5023,0.009648241204090805,48
سخوز,2018-11-24,5016,4975,0.008173843698529935,41
سخوز,2018-11-26,4864,5016,0.031249999993575243,152
سخوز,2018-11-27,4792,4864,0.0150250417330916,72
سخوز,2018-11-28,4716,4792,0.01611535198979742,76
سخوز,2018-12-01,4550,4716,0.03648351647549813,166
سخوز,2018-12-02,4335,4550,0.04959630910043914,215
سخوز,2018-12-03,4460,4335,0.02802690582331235,125
سخوز,2018-12-04,4537,4460,0.016971567111092888,77
سخوز,2018-12-05,4508,4537,0.006433007984375996,29
سخوز,2018-12-08,4418,4508,0.02037120868710475,90
سخوز,2018-12-09,4256,4418,0.0380639097654925,162
سخوز,2018-12-10,4281,4256,0.005839757064741939,25
سخوز,2018-12-11,4384,4281,0.0234945255420861,103
سخوز,2018-12-12,4394,4384,0.002275830677679601,10
سخوز,2018-12-15,4346,4394,0.01104463874573294,48
سخوز,2018-12-16,4244,4346,0.02403393024881387,102
سخوز,2018-12-17,4163,4244,0.01945712226292166,81
سخوز,2018-12-18,4141,4163,0.005312726393307721,22
سخوز,2018-12-19,4014,4141,0.03163926257308439,127
سخوز,2018-12-22,3836,4014,0.04640250259478559,178
سخوز,2018-12-23,4006,3836,0.04243634547118414,170
سخوز,2018-12-24,4020,4006,0.0034825870638103018,14
سخوز,2018-12-25,3937,4020,0.02108204215872948,83
سخوز,2018-12-26,3970,3937,0.008312342567175732,33
سخوز,2018-12-29,3927,3970,0.010949834476457898,43
سخوز,2018-12-30,3956,3927,0.007330637005224814,29
سخوز,2018-12-31,4069,3956,0.027770951086809794,113
سخوز,2019-01-01,4039,4069,0.007427581082587873,30
سخوز,2019-01-02,3886,4039,0.0393721049821482,153
سخوز,2019-01-05,3847,3886,0.010137769688032813,39
سخوز,2019-01-06,3823,3847,0.006277792308062309,24
سخوز,2019-01-07,3870,3823,0.012144702839239095,47
سخوز,2019-01-12,3942,3870,0.018264840178015006,72
سخوز,2019-01-13,3917,3942,0.006382435535771653,25
سخوز,2019-01-14,3882,3917,0.009015971146569816,35
سخوز,2019-01-15,3906,3882,0.006144393239594369,24
سخوز,2019-01-16,3906,3906,0,0
سخوز,2019-01-19,4073,3906,0.04100171862484613,167
سخوز,2019-01-20,4080,4073,0.0017156862740892926,7
سخوز,2019-01-21,3994,4080,0.021532298442280346,86
سخوز,2019-01-22,4119,3994,0.030347171636235206,125
سخوز,2019-01-23,4203,4119,0.01998572447775738,84
سخوز,2019-01-26,4131,4203,0.01742919389556301,72
سخوز,2019-01-27,4015,4131,0.028891656281720635,116
سخوز,2019-01-28,4182,4015,0.03993304637973863,167
سخوز,2019-01-29,4244,4182,0.01460885956300451,62
سخوز,2019-01-30,4444,4244,0.04500450043991797,200
سخوز,2019-02-02,4417,4444,0.006112746206449457,27
سخوز,2019-02-03,4198,4417,0.05216769889181331,219
سخوز,2019-02-04,4080,4198,0.02892156862036236,118
سخوز,2019-02-05,4046,4080,0.00840336134246086,34
سخوز,2019-02-06,4078,4046,0.007846983813671656,32
سخوز,2019-02-10,4033,4078,0.01115794693499679,45
سخوز,2019-02-12,4187,4033,0.03678051109701922,154
سخوز,2019-02-13,4099,4187,0.021468650885223553,88
سخوز,2019-02-16,4021,4099,0.019398159656951467,78
سخوز,2019-02-17,3989,4021,0.008022060664822748,32
سخوز,2019-02-18,4187,3989,0.04728922855331043,198
سخوز,2019-02-19,4392,4187,0.04667577412416307,205
سخوز,2019-02-20,4469,4392,0.017229805321720786,77
سخوز,2019-02-23,4251,4469,0.05128205126998775,218
سخوز,2019-02-24,4321,4251,0.016199953710668836,70
سخوز,2019-02-25,4267,4321,0.01265526130474449,54
سخوز,2019-02-26,4224,4267,0.010179924240014222,43
سخوز,2019-02-27,4317,4224,0.021542738007518474,93
سخوز,2019-03-02,4280,4317,0.008644859811064285,37
سخوز,2019-03-03,4307,4280,0.006268864637504326,27
سخوز,2019-03-04,4312,4307,0.0011595547307143889,5
سخوز,2019-03-05,4223,4312,0.02107506511459269,89
سخوز,2019-03-06,4191,4223,0.0076354092083905,32
سخوز,2019-03-09,4359,4191,0.038540949750277366,168
سخوز,2019-03-10,4467,4359,0.024177300196065076,108
سخوز,2019-03-11,4679,4467,0.04530882666268245,212
سخوز,2019-03-12,4897,4679,0.04451705124678026,218
سخوز,2019-03-13,4922,4897,0.005079236081861187,25
سخوز,2019-03-16,5081,4922,0.03129305254255205,159
سخوز,2019-03-17,5260,5081,0.03403041824448091,179
سخوز,2019-03-18,5219,5260,0.007855911092574074,41
سخوز,2019-03-19,5111,5219,0.021130894145738426,108
سخوز,2019-03-25,5048,5111,0.012480190171854161,63
سخوز,2019-03-26,5265,5048,0.04121557454107966,217
سخوز,2019-03-27,5525,5265,0.04705882352089433,260
سخوز,2019-03-30,5800,5525,0.04741379309527348,275
سخوز,2019-03-31,6081,5800,0.04620950500802343,281
سخوز,2019-04-06,6379,6081,0.04671578616605803,298
سخوز,2019-04-09,7028,6379,0.09234490607678643,649
سخوز,2019-04-10,7365,7028,0.04575695858170306,337
سخوز,2019-04-13,7049,7365,0.04482905376013207,316
سخوز,2019-04-14,6711,7049,0.05036507226190358,338
سخوز,2019-04-15,6719,6711,0.0011906533708601497,8
سخوز,2019-04-16,6566,6719,0.023301858053106632,153
سخوز,2019-04-17,6756,6566,0.028123149788614098,190
سخوز,2019-04-20,7091,6756,0.04724298405764448,335
سخوز,2019-04-22,7181,7091,0.012533073386362194,90
سخوز,2019-04-23,6973,7181,0.02982934174245958,208
سخوز,2019-04-24,6819,6973,0.022583956588563724,154
سخوز,2019-04-27,7049,6819,0.032628741660855616,230
سخوز,2019-04-28,7122,7049,0.01024992979356221,73
سخوز,2019-04-29,7328,7122,0.028111353707954236,206
سخوز,2019-04-30,7114,7328,0.03008152937446141,214
سخوز,2019-05-01,7147,7114,0.004617321952621055,33
سخوز,2019-05-04,7091,7147,0.007897334648442063,56
سخوز,2019-05-05,6792,7091,0.044022379263247584,299
سخوز,2019-05-06,6528,6792,0.0404411764643932,264
سخوز,2019-05-07,6206,6528,0.051885272308751965,322
سخوز,2019-05-08,6055,6206,0.024938067708515595,151
سخوز,2019-05-11,6303,6055,0.039346343005021996,248
سخوز,2019-05-12,6016,6303,0.04770611701334672,287
سخوز,2019-05-13,6315,6016,0.047347585107308375,299
سخوز,2019-05-14,6469,6315,0.023805843248754698,154
سخوز,2019-05-15,6264,6469,0.03272669220422626,205
سخوز,2019-05-18,6573,6264,0.047010497482578656,309
سخوز,2019-05-19,6624,6573,0.00769927536115651,51
سخوز,2019-05-20,6487,6624,0.02111916139646691,137
سخوز,2019-05-21,6666,6487,0.026852685264498546,179
سخوز,2019-05-22,6767,6666,0.014925373132122745,101
سخوز,2019-05-25,6940,6767,0.02492795388689799,173
سخوز,2019-05-26,7276,6940,0.04617921934494513,336
سخوز,2019-05-28,7639,7276,0.04751930880383305,363
سخوز,2019-05-29,8005,7639,0.045721424104219685,366
سخوز,2019-06-01,7677,8005,0.042725022789797444,328
سخوز,2019-06-02,8039,7677,0.04503047642181484,362
سخوز,2019-06-03,8047,8039,9.941593139065291e-4,8
سخوز,2019-06-08,8325,8047,0.03339339338938217,278
سخوز,2019-06-09,8741,8325,0.04759180871209338,416
سخوز,2019-06-10,9166,8741,0.04636700850465121,425
سخوز,2019-06-16,8564,9166,0.0702942550128101,602
سخوز,2019-06-17,8570,8564,7.001166860326585e-4,6
سخوز,2019-06-18,8679,8570,0.012559050580417208,109
سخوز,2019-06-19,8477,8679,0.023829184850320963,202
سخوز,2019-06-22,8129,8477,0.04280969368399438,348
سخوز,2019-06-23,8148,8129,0.0023318605789970715,19
سخوز,2019-06-24,8521,8148,0.0437742049003903,373
سخوز,2019-06-25,8700,8521,0.02057471264131325,179
سخوز,2019-06-26,8886,8700,0.02093180283356608,186
سخوز,2019-06-30,9167,8886,0.030653430780991225,281
سخوز,2019-07-01,8722,9167,0.05102040815741568,445
سخوز,2019-07-02,8749,8722,0.0030860669787305902,27
سخوز,2019-07-03,8520,8749,0.02687793426914578,229
سخوز,2019-07-10,4872,8520,0.7487684727527157,3648
سخوز,2019-07-13,4934,4872,0.012565869474550897,62
سخوز,2019-07-14,4923,4934,0.0022344099122010136,11
سخوز,2019-07-15,4703,4923,0.046778651914357074,220
سخوز,2019-07-16,4475,4703,0.050949720659005646,228
سخوز,2019-07-17,4320,4475,0.035879629621324155,155
سخوز,2019-07-20,4238,4320,0.019348749405533563,82
سخوز,2019-07-21,4183,4238,0.013148458041322385,55
سخوز,2019-07-22,4227,4183,0.010409273714121297,44
سخوز,2019-07-23,4113,4227,0.027716994887498906,114
سخوز,2019-07-24,4205,4113,0.021878715809303513,92
سخوز,2019-07-27,4154,4205,0.012277323059153267,51
سخوز,2019-07-28,4109,4154,0.010951569722328651,45
سخوز,2019-07-29,4013,4109,0.023922252672832732,96
سخوز,2019-07-30,4058,4013,0.011089206502935139,45
سخوز,2019-07-31,4214,4058,0.03701945893758437,156
سخوز,2019-08-03,4121,4214,0.02256733801927509,93
سخوز,2019-08-04,4018,4121,0.025634644095163105,103
سخوز,2019-08-05,4111,4018,0.022622233027822368,93
سخوز,2019-08-06,4124,4111,0.0031522793396817944,13
سخوز,2019-08-07,4202,4124,0.018562589238799953,78
سخوز,2019-08-10,4159,4202,0.01033902380131305,43
سخوز,2019-08-11,4140,4159,0.004589371979567785,19
سخوز,2019-08-13,4100,4140,0.009756097558596072,40
سخوز,2019-08-14,4267,4100,0.03913756736837647,167
سخوز,2019-08-17,4480,4267,0.04754464284653021,213
سخوز,2019-08-18,4598,4480,0.025663331877846165,118
سخوز,2019-08-19,4576,4598,0.004807692306641675,22
سخوز,2019-08-21,4769,4576,0.0404697001382953,193
سخوز,2019-08-24,5000,4769,0.04619999999075999,231
سخوز,2019-08-25,4875,5000,0.02564102563576594,125
سخوز,2019-08-26,4903,4875,0.00571078931150096,28
سخوز,2019-08-27,5076,4903,0.034081954288005915,173
سخوز,2019-08-28,5285,5076,0.03954588457151449,209
سخوز,2019-08-31,5412,5285,0.023466371023010645,127
سخوز,2019-09-01,5261,5412,0.02870176771931158,151
سخوز,2019-09-02,5064,5261,0.03890205370479817,197
سخوز,2019-09-03,5060,5064,7.905138338358667e-4,4
سخوز,2019-09-04,5180,5060,0.02316602316155096,120
سخوز,2019-09-07,5206,5180,0.004994237417404103,26
سخوز,2019-09-08,5130,5206,0.014814814811926936,76
سخوز,2019-09-11,5347,5130,0.040583504761439404,217
سخوز,2019-09-14,5594,5347,0.04415445118981865,247
سخوز,2019-09-15,5504,5594,0.016351744183075625,90
سخوز,2019-09-16,5508,5504,7.262164123590746e-4,4
سخوز,2019-09-17,5414,5508,0.017362393790660804,94
سخوز,2019-09-18,5201,5414,0.04095366274928789,213
سخوز,2019-09-21,5078,5201,0.02422213469393026,123
سخوز,2019-09-22,5330,5078,0.04727954970970365,252
سخوز,2019-09-23,5594,5330,0.04719342151462398,264
سخوز,2019-09-24,5616,5594,0.003917378916681378,22
سخوز,2019-09-25,5652,5616,0.006369426750465423,36
سخوز,2019-09-28,5665,5652,0.0022947925856496394,13
سخوز,2019-09-29,5523,5665,0.025710664489279254,142
سخوز,2019-09-30,5495,5523,0.00509554140034658,28
سخوز,2019-10-01,5400,5495,0.017592592589334703,95
سخوز,2019-10-02,5200,5400,0.03846153845414201,200
سخوز,2019-10-05,5409,5200,0.03863930485512307,209
سخوز,2019-10-06,5312,5409,0.018260542165237096,97
سخوز,2019-10-07,5433,5312,0.02227130498393681,121
سخوز,2019-10-08,5338,5433,0.017796927684938752,95
سخوز,2019-10-09,5333,5338,9.37558597236535e-4,5
سخوز,2019-10-12,5315,5333,0.0033866415797955515,18
سخوز,2019-10-13,5408,5315,0.017196745558950306,93
سخوز,2019-10-14,5149,5408,0.050301029316313646,259
سخوز,2019-10-15,4928,5149,0.04484577921167902,221
سخوز,2019-10-16,4716,4928,0.04495335028732965,212
سخوز,2019-10-20,4512,4716,0.045212765947426244,204
سخوز,2019-10-21,4379,4512,0.030372231096055666,133
سخوز,2019-10-22,4590,4379,0.04596949890066024,211
سخوز,2019-10-23,4460,4590,0.029147982056244845,130
سخوز,2019-10-26,4401,4460,0.01340604407784457,59
سخوز,2019-10-28,4581,4401,0.039292730836216386,180
سخوز,2019-10-30,4759,4581,0.03740281570972834,178
سخوز,2019-11-02,4709,4759,0.01061796559553664,50
سخوز,2019-11-03,4704,4709,0.001062925169842065,5
سخوز,2019-11-04,4484,4704,0.049063336295927,220
سخوز,2019-11-05,4478,4484,0.0013398838764314685,6
سخوز,2019-11-09,4460,4478,0.004035874438556978,18
سخوز,2019-11-10,4351,4460,0.025051712244299765,109
سخوز,2019-11-11,4492,4351,0.031389136235220584,141
سخوز,2019-11-12,4712,4492,0.046689303895015,220
سخوز,2019-11-13,4789,4712,0.016078513256195758,77
سخوز,2019-11-16,4648,4789,0.030335628220667894,141
سخوز,2019-11-17,4472,4648,0.0393559928355644,176
سخوز,2019-11-18,4464,4472,0.0017921146949390423,8
سخوز,2019-11-19,4509,4464,0.00998003991794632,45
سخوز,2019-11-20,4538,4509,0.0063904803864278355,29
سخوز,2019-11-23,4487,4538,0.01136616892993845,51
سخوز,2019-11-24,4516,4487,0.006421612044636489,29
سخوز,2019-11-25,4727,4516,0.044637190597707384,211
سخوز,2019-11-26,4732,4727,0.0010566356717969915,5
سخوز,2019-11-27,4710,4732,0.0046709129501760266,22
سخوز,2019-11-30,4793,4710,0.017316920505462772,83
سخوز,2019-12-01,4996,4793,0.040632505996670835,203
سخوز,2019-12-02,4997,4996,2.001200720031779e-4,1
سخوز,2019-12-03,4878,4997,0.024395243947438448,119
سخوز,2019-12-04,4835,4878,0.008893485003331232,43
سخوز,2019-12-07,4955,4835,0.024217961650006465,120
سخوز,2019-12-08,5125,4955,0.03317073170084473,170
سخوز,2019-12-09,5304,5125,0.033748114624104805,179
سخوز,2019-12-10,5369,5304,0.012106537528011448,65
سخوز,2019-12-11,5316,5369,0.009969902180216346,53
سخوز,2019-12-14,5362,5316,0.00857888847284989,46
سخوز,2019-12-15,5360,5362,3.7313432828859434e-4,2
سخوز,2019-12-16,5547,5360,0.033711916345103315,187
سخوز,2019-12-17,5822,5547,0.04723462726773709,275
سخوز,2019-12-18,5991,5822,0.028208980132163414,169
سخوز,2019-12-21,6085,5991,0.015447822511840948,94
سخوز,2019-12-22,6291,6085,0.03274519153826972,206
سخوز,2019-12-23,6567,6291,0.04202832342895868,276
سخوز,2019-12-24,6840,6567,0.039912280695919254,273
سخوز,2019-12-25,6581,6840,0.0393557210090631,259
سخوز,2019-12-28,6863,6581,0.041089902369067476,282
سخوز,2019-12-29,6937,6863,0.010667435489308428,74
سخوز,2019-12-30,7239,6937,0.041718469396088066,302
سخوز,2019-12-31,7581,7239,0.04511278194893645,342
سخوز,2020-01-01,7843,7581,0.03340558459347117,262
سخوز,2020-01-04,7451,7843,0.052610387860339496,392
سخوز,2020-01-05,7079,7451,0.05254979516138582,372
سخوز,2020-01-07,6735,7079,0.05107646621364863,344
سخوز,2020-01-08,6640,6735,0.014307228913507946,95
سخوز,2020-01-11,6766,6640,0.01862252438388671,126
سخوز,2020-01-12,7104,6766,0.04757882882213136,338
سخوز,2020-01-13,7404,7104,0.040518638568271384,300
سخوز,2020-01-14,7489,7404,0.011349979969108028,85
سخوز,2020-01-15,7460,7489,0.003887399463285871,29
سخوز,2020-01-18,7733,7460,0.035303245824996346,273
سخوز,2020-01-19,8031,7733,0.037106213418365556,298
سخوز,2020-01-20,8422,8031,0.04642602706644193,391
سخوز,2020-01-21,8812,8422,0.04425783022648005,390
سخوز,2020-01-22,8997,8812,0.02056240968983412,185
سخوز,2020-01-25,9011,8997,0.0015536566417097262,14
سخوز,2020-01-26,8723,9011,0.03301616415992019,288
سخوز,2020-01-27,8424,8723,0.03549382715628041,299
سخوز,2020-01-28,8372,8424,0.006211180123481703,52
سخوز,2020-02-01,8728,8372,0.0407882676396897,356
سخوز,2020-02-02,8989,8728,0.02903548781521465,261
سخوز,2020-02-03,8899,8989,0.010113495897279076,90
سخوز,2020-02-04,8529,8899,0.04338140461444701,370
سخوز,2020-02-05,8253,8529,0.03344238458337061,276
سخوز,2020-02-08,8237,8253,0.001942454776988897,16
سخوز,2020-02-09,8305,8237,0.008187838650428917,68
سخوز,2020-02-10,7998,8305,0.03838459614423798,307
سخوز,2020-02-12,8307,7998,0.0371975442353199,309
سخوز,2020-02-15,8447,8307,0.01657393157137754,140
سخوز,2020-02-16,8546,8447,0.011584366953945194,99
سخوز,2020-02-17,8434,8546,0.013279582640113873,112
سخوز,2020-02-18,8255,8434,0.02168382798041383,179
سخوز,2020-02-19,8512,8255,0.030192669169385258,257
سخوز,2020-02-22,8637,8512,0.014472617805433297,125
سخوز,2020-02-23,9068,8637,0.047529775027841885,431
سخوز,2020-02-24,9159,9068,0.0099355824860863,91
سخوز,2020-02-25,9478,9159,0.03365688963561333,319
سخوز,2020-02-26,9692,9478,0.02208006603156417,214
سخوز,2020-02-29,9208,9692,0.0525629886997651,484
سخوز,2020-03-01,9134,9208,0.008101598422585767,74
سخوز,2020-03-02,9570,9134,0.04555903865772633,436
سخوز,2020-03-03,9911,9570,0.034406215312843685,341
سخوز,2020-03-04,10401,9911,0.04711085472097771,490
سخوز,2020-03-07,10300,10401,0.009805825241766425,101
سخوز,2020-03-09,10197,10300,0.010101010100019514,103
سخوز,2020-03-10,9935,10197,0.026371414189595228,262
سخوز,2020-03-11,9873,9935,0.006279752860702952,62
سخوز,2020-03-14,9782,9873,0.009302801062226251,91
سخوز,2020-03-15,9766,9782,0.001638337087688067,16
سخوز,2020-03-16,9503,9766,0.027675470901012786,263
سخوز,2020-03-17,9286,9503,0.023368511735583835,217
سخوز,2020-03-18,9456,9286,0.017978003382193526,170
سخوز,2020-03-24,9364,9456,0.009824861169390766,92
سخوز,2020-03-25,9587,9364,0.023260665482084,223
سخوز,2020-03-28,9786,9587,0.02033517269360973,199
سخوز,2020-03-29,10102,9786,0.03128093446532559,316
سخوز,2020-03-30,10437,10102,0.032097345977570434,335
سخوز,2020-04-04,10925,10437,0.04466819221559101,488
سخوز,2020-04-05,11143,10925,0.019563851743734734,218
سخوز,2020-04-06,11530,11143,0.033564614047392485,387
سخوز,2020-04-07,11767,11530,0.020141072489152624,237
سخوز,2020-04-08,12298,11767,0.043177752476567105,531
سخوز,2020-04-11,12426,12298,0.010300981811500002,128
سخوز,2020-04-12,12487,12426,0.004885080483311838,61
سخوز,2020-04-13,13012,12487,0.04034737165383128,525
سخوز,2020-04-14,12944,13012,0.005253399257937778,68
سخوز,2020-04-15,13360,12944,0.031137724548567534,416
سخوز,2020-04-18,13827,13360,0.03377449916585127,467
سخوز,2020-04-19,14433,13827,0.04198711286343885,606
سخوز,2020-04-21,14997,14433,0.03760752150179319,564
سخوز,2020-04-22,14991,14997,4.0024014405975317e-4,6
سخوز,2020-04-25,15603,14991,0.03922322630012028,612
سخوز,2020-04-26,15647,15603,0.0028120406465896313,44
سخوز,2020-04-27,15325,15647,0.021011419248221114,322
سخوز,2020-04-28,15900,15325,0.03616352201030418,575
سخوز,2020-04-29,16673,15900,0.046362382291947314,773
سخوز,2020-05-02,17506,16673,0.04758368559079266,833
سخوز,2020-05-03,18348,17506,0.045890560276548364,842
سخوز,2020-05-04,19208,18348,0.044773011242983496,860
سخوز,2020-05-05,18964,19208,0.01286648386348521,244
سخوز,2020-05-06,18172,18964,0.04358353510656045,792
سخوز,2020-05-09,18949,18172,0.0410048023620769,777
سخوز,2020-05-10,18308,18949,0.035012016602850554,641
سخوز,2020-05-11,17445,18308,0.0494697621066512,863
سخوز,2020-05-12,17137,17445,0.017972807374804643,308
سخوز,2020-05-13,16349,17137,0.04819866658216413,788
سخوز,2020-05-16,15733,16349,0.0391533718909837,616
سخوز,2020-05-17,15330,15733,0.02628832354688269,403
سخوز,2020-05-18,15958,15330,0.03935330241638343,628
سخوز,2020-05-19,16755,15958,0.04756789017919619,797
سخوز,2020-05-20,17135,16755,0.022176831046269226,380
سخوز,2020-05-23,17991,17135,0.04757934522552502,856
سخوز,2020-05-26,18700,17991,0.03791443850064628,709
سخوز,2020-05-27,19385,18700,0.03533660046245362,685
سخوز,2020-05-30,19633,19385,0.012631793408412785,248
سخوز,2020-05-31,20274,19633,0.031616849164860565,641
سخوز,2020-06-01,20499,20274,0.010976145177278103,225
سخوز,2020-06-02,20908,20499,0.01956189018463928,409
سخوز,2020-06-06,21953,20908,0.04760169452705317,1045
سخوز,2020-06-07,23050,21953,0.04759219088730619,1097
سخوز,2020-06-08,23420,23050,0.015798462851588452,370
سخوز,2020-06-09,23621,23420,0.008509377248697795,201
سخوز,2020-06-20,27450,23621,0.13948998177998215,3829
سخوز,2020-06-21,26170,27450,0.04891096675395831,1280
سخوز,2020-06-22,27020,26170,0.03145817912540865,850
سخوز,2020-06-23,27300,27020,0.010256410256034564,280
سخوز,2020-06-24,26560,27300,0.02786144578208353,740
سخوز,2020-06-27,27340,26560,0.028529626919219838,780
سخوز,2020-06-28,26180,27340,0.0443086325422342,1160
سخوز,2020-06-29,24880,26180,0.05225080385642079,1300
سخوز,2020-07-01,26370,24880,0.05650360257654518,1490
سخوز,2020-07-04,25110,26370,0.05017921146753567,1260
سخوز,2020-07-05,24760,25110,0.014135702745794195,350
سخوز,2020-07-06,25940,24760,0.045489591362934095,1180
سخوز,2020-07-07,25090,25940,0.03387803905803595,850
سخوز,2020-07-08,23900,25090,0.0497907949769962,1190
سخوز,2020-07-11,22830,23900,0.0468681559331201,1070
سخوز,2020-07-12,23860,22830,0.04316848281461993,1030
سخوز,2020-07-13,23040,23860,0.03559027777623306,820
سخوز,2020-07-14,24140,23040,0.04556752278187375,1100
سخوز,2020-07-15,25340,24140,0.04735595895630008,1200
سخوز,2020-07-18,26600,25340,0.04736842105085081,1260
سخوز,2020-07-19,27750,26600,0.04144144143994805,1150
سخوز,2020-07-20,29110,27750,0.046719340431236024,1360
سخوز,2020-07-21,29670,29110,0.01887428378770225,560
سخوز,2020-07-22,28330,29670,0.04729968231389694,1340
سخوز,2020-07-25,29310,28330,0.03343568747753546,980
سخوز,2020-07-26,27930,29310,0.04940923737739315,1380
سخوز,2020-07-27,26540,27930,0.052373775431334826,1390
سخوز,2020-07-28,25650,26540,0.03469785574913459,890
سخوز,2020-07-29,25900,25650,0.009652509652136968,250
سخوز,2020-08-01,27180,25900,0.04709345106522835,1280
سخوز,2020-08-02,26530,27180,0.024500565396739518,650
سخوز,2020-08-03,25480,26530,0.04120879120717391,1050
سخوز,2020-08-04,26210,25480,0.027851964897830907,730
سخوز,2020-08-05,27470,26210,0.04586821987455886,1260
سخوز,2020-08-09,26740,27470,0.027299925204663428,730
سخوز,2020-08-10,25430,26740,0.05151395988786811,1310
سخوز,2020-08-11,24310,25430,0.04607157548144502,1120
سخوز,2020-08-12,25380,24310,0.04215918045539168,1070
سخوز,2020-08-15,24170,25380,0.05006206040339007,1210
سخوز,2020-08-16,23090,24170,0.04677349501746325,1080
سخوز,2020-08-17,23750,23090,0.027789473683040442,660
سخوز,2020-08-18,24100,23750,0.01452282157616088,350
سخوز,2020-08-19,23040,24100,0.046006944442447614,1060
سخوز,2020-08-22,22090,23040,0.043005885013897426,950
سخوز,2020-08-23,21440,22090,0.03031716417769043,650
سخوز,2020-08-24,20450,21440,0.048410757943842996,990
سخوز,2020-08-25,20700,20450,0.012077294685406893,250
سخوز,2020-08-26,21110,20700,0.019422074845124485,410
سخوز,2020-08-31,20890,21110,0.010531354714670592,220
سخوز,2020-09-01,19850,20890,0.052392947100635114,1040
سخوز,2020-09-02,19040,19850,0.04254201680448834,810
سخوز,2020-09-05,18510,19040,0.028633171257232134,530
سخوز,2020-09-06,18420,18510,0.004885993485076764,90
سخوز,2020-09-07,17630,18420,0.04480998298100908,790
سخوز,2020-09-08,17010,17630,0.03644914755811586,620
سخوز,2020-09-09,17340,17010,0.019031141867414583,330
وپاسار,2019-01-15,1308,1325,0.012996941886087963,17
وپاسار,2019-01-16,1314,1308,0.004566210042187054,6
وپاسار,2019-01-19,1295,1314,0.014671814660485083,19
وپاسار,2019-01-20,1251,1295,0.03517186248187701,44
وپاسار,2019-01-21,1192,1251,0.04949664425377798,59
وپاسار,2019-01-22,1223,1192,0.02534750611173548,31
وپاسار,2019-01-23,1235,1223,0.009716599182415709,12
وپاسار,2019-01-26,1222,1235,0.01063829786363478,13
وپاسار,2019-01-27,1200,1222,0.018333333318055554,22
وپاسار,2019-01-28,1163,1200,0.03181427340342711,37
وپاسار,2019-01-29,1154,1163,0.007798960131889982,9
وپاسار,2019-01-30,1136,1154,0.015845070408587084,18
وپاسار,2019-02-02,1119,1136,0.015192135821990941,17
وپاسار,2019-02-03,1091,1119,0.025664527932479808,28
وپاسار,2019-02-04,1089,1091,0.0018365472894062926,2
وپاسار,2019-02-05,1075,1089,0.01302325580183883,14
وپاسار,2019-02-06,1070,1075,0.004672897191894488,5
وپاسار,2019-02-10,1068,1070,0.0018726591742765362,2
وپاسار,2019-02-12,1066,1068,0.001876172606119913,2
وپاسار,2019-02-13,1067,1066,9.372071218957758e-4,1
وپاسار,2019-02-16,1062,1067,0.0047080979240036736,5
وپاسار,2019-02-17,1057,1062,0.004730368964304286,5
وپاسار,2019-02-18,1075,1057,0.01674418603093564,18
وپاسار,2019-02-19,1074,1075,9.310986955948801e-4,1
وپاسار,2019-02-20,1067,1074,0.00656044985327043,7
وپاسار,2019-02-23,1072,1067,0.004664179100126698,5
وپاسار,2019-02-24,1075,1072,0.0027906976718226066,3
وپاسار,2019-02-25,1068,1075,0.0065543071099678765,7
وپاسار,2019-02-26,1057,1068,0.01040681172146943,11
وپاسار,2019-02-27,1055,1057,0.001895734595359493,2
وپاسار,2019-03-02,1050,1055,0.004761904757369614,5
وپاسار,2019-03-03,1043,1050,0.006711409389538437,7
وپاسار,2019-03-04,1032,1043,0.010658914718353764,11
وپاسار,2019-03-05,1034,1032,0.0019342359749185336,2
وپاسار,2019-03-06,1036,1034,0.0019305019286385114,2
وپاسار,2019-03-09,1038,1036,0.0019267822717468376,2
وپاسار,2019-03-10,1041,1038,0.0028818443776351156,3
وپاسار,2019-03-11,1046,1041,0.004780114718183446,5
وپاسار,2019-03-12,1049,1046,0.0028598665368352078,3
وپاسار,2019-03-13,1077,1049,0.025998142965647033,28
وپاسار,2019-03-16,1098,1077,0.019125683042690633,21
وپاسار,2019-03-17,1098,1098,0,0
وپاسار,2019-03-18,1107,1098,0.00813008129346876,9
وپاسار,2019-03-19,1123,1107,0.014247551189450086,16
وپاسار,2019-03-25,1141,1123,0.015775635393711098,18
وپاسار,2019-03-26,1192,1141,0.042785234863435204,51
وپاسار,2019-03-27,1184,1192,0.006756756751050036,8
وپاسار,2019-03-30,1185,1184,8.438818558279477e-4,1
وپاسار,2019-03-31,1181,1185,0.003386960200349737,4
وپاسار,2019-04-06,1229,1181,0.03905614317407962,48
وپاسار,2019-04-07,1289,1229,0.046547711368077796,60
وپاسار,2019-04-08,1327,1289,0.028636021078646552,38
وپاسار,2019-04-09,1383,1327,0.040491684714033485,56
وپاسار,2019-04-10,1436,1383,0.036908077968726964,53
وپاسار,2019-04-13,1424,1436,0.008426966286217018,12
وپاسار,2019-04-14,1419,1424,0.003523608172287802,5
وپاسار,2019-04-15,1447,1419,0.01935038008337914,28
وپاسار,2019-04-16,1468,1447,0.014305177101971949,21
وپاسار,2019-04-17,1416,1468,0.03672316381587347,52
وپاسار,2019-04-20,1481,1416,0.04388926398116862,65
وپاسار,2019-04-22,1434,1481,0.03277545325468936,47
وپاسار,2019-04-23,1400,1434,0.024285714268367346,34
وپاسار,2019-04-24,1419,1400,0.01338971105469365,19
وپاسار,2019-04-27,1398,1419,0.015021459216722845,21
وپاسار,2019-04-28,1414,1398,0.011315417248008898,16
وپاسار,2019-04-29,1414,1414,0,0
وپاسار,2019-04-30,1410,1414,0.002836879430612142,4
وپاسار,2019-05-01,1411,1410,7.087172213262103e-4,1
وپاسار,2019-05-04,1478,1411,0.04533152906269856,67
وپاسار,2019-05-05,1546,1478,0.04398447603881987,68
وپاسار,2019-05-06,1538,1546,0.005201560464758413,8
وپاسار,2019-05-07,1463,1538,0.051264524913694785,75
وپاسار,2019-05-08,1455,1463,0.0054982817831626925,8
وپاسار,2019-05-11,1404,1455,0.03632478629891397,51
وپاسار,2019-05-12,1339,1404,0.048543689284134654,65
وپاسار,2019-05-13,1348,1339,0.006676557858548547,9
وپاسار,2019-05-14,1406,1348,0.04125177806454354,58
وپاسار,2019-05-15,1370,1406,0.026277372243593156,36
وپاسار,2019-05-18,1433,1370,0.04396371246059755,63
وپاسار,2019-05-19,1421,1433,0.008444757207287292,12
وپاسار,2019-05-20,1419,1421,0.0014094432689151209,2
وپاسار,2019-05-21,1460,1419,0.02808219176158754,41
وپاسار,2019-05-22,1470,1460,0.006802721083807672,10
وپاسار,2019-05-25,1425,1470,0.031578947346260385,45
وپاسار,2019-05-26,1484,1425,0.03975741237213112,59
وپاسار,2019-05-28,1535,1484,0.03322475567868094,51
وپاسار,2019-05-29,1527,1535,0.005239030775874898,8
وپاسار,2019-06-01,1500,1527,0.017999999987999997,27
وپاسار,2019-06-02,1534,1500,0.022164276387115853,34
وپاسار,2019-06-03,1522,1534,0.007884362675503047,12
وپاسار,2019-06-08,1511,1522,0.007279947050112543,11
وپاسار,2019-06-09,1526,1511,0.009829619914921612,15
وپاسار,2019-06-10,1565,1526,0.02492012777960375,39
وپاسار,2019-06-11,1539,1565,0.01689408705854835,26
وپاسار,2019-06-12,1608,1539,0.042910447734508424,69
وپاسار,2019-06-15,1662,1608,0.032490974709692554,54
وپاسار,2019-06-16,1729,1662,0.03875072293883706,67
وپاسار,2019-06-17,1720,1729,0.005232558136492698,9
وپاسار,2019-06-18,1805,1720,0.047091412716292844,85
وپاسار,2019-06-19,1812,1805,0.0038631346557046714,7
وپاسار,2019-06-22,1794,1812,0.010033444810460732,18
وپاسار,2019-06-23,1811,1794,0.009387078956716135,17
وپاسار,2019-06-24,1814,1811,0.0016538037477101411,3
وپاسار,2019-06-25,1808,1814,0.00331858406896096,6
وپاسار,2019-06-26,1822,1808,0.007683863881622467,14
وپاسار,2019-06-30,1801,1822,0.011660188777534598,21
وپاسار,2019-07-01,1778,1801,0.012935883007347647,23
وپاسار,2019-07-02,1761,1778,0.009653605900253489,17
وپاسار,2019-07-03,1764,1761,0.001700680271144739,3
وپاسار,2019-07-06,1730,1764,0.019653179179391224,34
وپاسار,2019-07-07,1724,1730,0.003480278420255059,6
وپاسار,2019-07-08,1801,1724,0.04275402551762686,77
وپاسار,2019-07-09,1769,1801,0.018089315987513104,32
وپاسار,2019-07-10,1762,1769,0.0039727582270302165,7
وپاسار,2019-07-13,1794,1762,0.01783723521859686,32
وپاسار,2019-07-14,1822,1794,0.015367727763244934,28
وپاسار,2019-07-15,1829,1822,0.0038272279913465126,7
وپاسار,2019-07-16,1762,1829,0.038024971601574926,67
وپاسار,2019-07-17,1764,1762,0.0011337868474298259,2
وپاسار,2019-07-23,1742,1764,0.012629161875643419,22
وپاسار,2019-07-24,1714,1742,0.016336055999803933,28
وپاسار,2019-07-27,1735,1714,0.012103746390718302,21
وپاسار,2019-07-28,1754,1735,0.010832383118111525,19
وپاسار,2019-07-29,1754,1754,0,0
وپاسار,2019-07-30,1762,1754,0.004540295116605962,8
وپاسار,2019-07-31,1785,1762,0.012885154054406076,23
وپاسار,2019-08-06,1750,1785,0.019999999988571427,35
وپاسار,2019-08-07,1703,1750,0.027598355826424923,47
وپاسار,2019-08-10,1690,1703,0.007692307687756031,13
وپاسار,2019-08-11,1677,1690,0.00775193797987362,13
وپاسار,2019-08-13,1641,1677,0.021937842765424834,36
وپاسار,2019-08-14,1663,1641,0.013229104020908536,22
وپاسار,2019-08-17,1657,1663,0.0036210018083156293,6
وپاسار,2019-08-18,1640,1657,0.010365853652215942,17
وپاسار,2019-08-19,1707,1640,0.03925014643277671,67
وپاسار,2019-08-21,1792,1707,0.047433035687816386,85
وپاسار,2019-08-24,1878,1792,0.04579339720671278,86
وپاسار,2019-08-25,1874,1878,0.0021344717171107408,4
وپاسار,2019-08-26,1956,1874,0.04192229036711539,82
وپاسار,2019-08-27,1925,1956,0.016103896095530444,31
وپاسار,2019-08-28,1889,1925,0.019057702478000156,36
وپاسار,2019-08-31,1973,1889,0.042574759228294595,84
وپاسار,2019-09-01,2006,1973,0.01645064804763178,33
وپاسار,2019-09-02,1956,2006,0.02556237217507036,50
وپاسار,2019-09-03,1962,1956,0.0030581039739765014,6
وپاسار,2019-09-04,2043,1962,0.03964757707310446,81
وپاسار,2019-09-07,2040,2043,0.001470588234573241,3
وپاسار,2019-09-08,2017,2040,0.011403073866433775,23
وپاسار,2019-09-11,2115,2017,0.046335697377619056,98
وپاسار,2019-09-14,2186,2115,0.032479414440768795,71
وپاسار,2019-09-15,2204,2186,0.008166969143299924,18
وپاسار,2019-09-16,2223,2204,0.00854700854316374,19
وپاسار,2019-09-17,2196,2223,0.012295081961614262,27
وپاسار,2019-09-18,2130,2196,0.03098591547841037,66
وپاسار,2019-09-21,2229,2130,0.04441453564629227,99
وپاسار,2019-09-22,2317,2229,0.037980146725084096,88
وپاسار,2019-09-23,2332,2317,0.006432246995526481,15
وپاسار,2019-09-24,2328,2332,0.00171821305768118,4
وپاسار,2019-09-25,2434,2328,0.04354971238966734,106
وپاسار,2019-09-28,2549,2434,0.045115731641774924,115
وپاسار,2019-09-29,2628,2549,0.030060882789170136,79
وپاسار,2019-09-30,2653,2628,0.009423294380164609,25
وپاسار,2019-10-01,2648,2653,0.0018882175219455373,5
وپاسار,2019-10-02,2586,2648,0.023975251344170438,62
وپاسار,2019-10-05,2690,2586,0.03866171002280234,104
وپاسار,2019-10-06,2560,2690,0.050781249980163576,130
وپاسار,2019-10-07,2466,2560,0.03811841036572652,94
وپاسار,2019-10-08,2357,2466,0.046245226963833166,109
وپاسار,2019-10-09,2306,2357,0.02211621855068681,51
وپاسار,2019-10-12,2346,2306,0.017050298372953836,40
وپاسار,2019-10-13,2352,2346,0.002551020407078648,6
وپاسار,2019-10-14,2242,2352,0.04906333628498513,110
وپاسار,2019-10-15,2143,2242,0.04619692018376252,99
وپاسار,2019-10-16,2134,2143,0.0042174320505072955,9
وپاسار,2019-10-20,2050,2134,0.04097560973610946,84
وپاسار,2019-10-21,2119,2050,0.0325625294796779,69
وپاسار,2019-10-22,2206,2119,0.03943789662763468,87
وپاسار,2019-10-23,2184,2206,0.010073260068647776,22
وپاسار,2019-10-26,2160,2184,0.011111111105967079,24
وپاسار,2019-10-28,2174,2160,0.006439742407341425,14
وپاسار,2019-10-30,2229,2174,0.024674742025717927,55
وپاسار,2019-11-02,2179,2229,0.02294630563426053,50
وپاسار,2019-11-03,2103,2179,0.03613884924577326,76
وپاسار,2019-11-04,2007,2103,0.047832585925345,96
وپاسار,2019-11-05,1989,2007,0.009049773751106197,18
وپاسار,2019-11-09,2087,1989,0.04695735503260309,98
وپاسار,2019-11-10,2096,2087,0.0042938931277223796,9
وپاسار,2019-11-11,2112,2096,0.007575757572170569,16
وپاسار,2019-11-12,2176,2112,0.029411764692365918,64
وپاسار,2019-11-13,2161,2176,0.006941230908402948,15
وپاسار,2019-11-16,2132,2161,0.013602251400749414,29
وپاسار,2019-11-17,2066,2132,0.03194578894871937,66
وپاسار,2019-11-18,2071,2066,0.002414292611098845,5
وپاسار,2019-11-19,2100,2071,0.013809523802947846,29
وپاسار,2019-11-20,2114,2100,0.006622516553158696,14
وپاسار,2019-11-23,2128,2114,0.006578947365329442,14
وپاسار,2019-11-24,2140,2128,0.005607476632893703,12
وپاسار,2019-11-25,2198,2140,0.026387625101734476,58
وپاسار,2019-11-26,2234,2198,0.016114592651694452,36
وپاسار,2019-11-27,2281,2234,0.02060499779894564,47
وپاسار,2019-11-30,2299,2281,0.007829491079673992,18
وپاسار,2019-12-01,2312,2299,0.0056228373678101915,13
وپاسار,2019-12-02,2296,2312,0.006968641111947456,16
وپاسار,2019-12-03,2276,2296,0.008787346217580252,20
وپاسار,2019-12-04,2291,2276,0.006547359228918657,15
وپاسار,2019-12-07,2314,2291,0.009939498699248272,23
وپاسار,2019-12-08,2385,2314,0.029769392021061054,71
وپاسار,2019-12-09,2383,2385,8.392782203779782e-4,2
وپاسار,2019-12-10,2390,2383,0.002928870291661561,7
وپاسار,2019-12-11,2326,2390,0.027515047279658193,64
وپاسار,2019-12-14,2298,2326,0.01218450826275696,28
وپاسار,2019-12-15,2262,2298,0.015915119356359364,36
وپاسار,2019-12-16,2247,2262,0.006675567420260095,15
وپاسار,2019-12-17,2225,2247,0.009887640444994319,22
وپاسار,2019-12-18,2332,2225,0.04588336190142223,107
وپاسار,2019-12-21,2393,2332,0.02549101545111115,61
وپاسار,2019-12-22,2372,2393,0.008853288360517164,21
وپاسار,2019-12-23,2401,2372,0.01207830070300779,29
وپاسار,2019-12-24,2408,2401,0.0029069767429788303,7
وپاسار,2019-12-25,2375,2408,0.013894736836254848,33
وپاسار,2019-12-28,2418,2375,0.017783291969485818,43
وپاسار,2019-12-29,2421,2418,0.0012391573724745324,3
وپاسار,2019-12-30,2476,2421,0.022213247163888027,55
وپاسار,2019-12-31,2456,2476,0.008143322472254348,20
وپاسار,2020-01-01,2472,2456,0.006472491906766791,16
وپاسار,2020-01-04,2349,2472,0.05236270751282984,123
وپاسار,2020-01-05,2244,2349,0.04679144382941558,105
وپاسار,2020-01-07,2204,2244,0.018148820318444274,40
وپاسار,2020-01-08,2160,2204,0.020370370360939645,44
وپاسار,2020-01-11,2188,2160,0.012797074948447408,28
وپاسار,2020-01-12,2297,2188,0.047453199805201046,109
وپاسار,2020-01-13,2406,2297,0.04530340812747157,109
وپاسار,2020-01-14,2493,2406,0.03489771358407633,87
وپاسار,2020-01-15,2609,2493,0.04446147947701745,116
وپاسار,2020-01-18,2738,2609,0.047114682232609686,129
وپاسار,2020-01-19,2740,2738,7.299270070328734e-4,2
وپاسار,2020-01-20,2836,2740,0.03385049364109644,96
وپاسار,2020-01-21,2808,2836,0.009971509967958864,28
وپاسار,2020-01-22,2861,2808,0.01852499125532157,53
وپاسار,2020-01-25,2859,2861,6.995452953132056e-4,2
وپاسار,2020-01-26,2799,2859,0.021436227216350044,60
وپاسار,2020-01-27,2844,2799,0.015822784804563016,45
وپاسار,2020-01-28,2982,2844,0.04627766598045686,138
وپاسار,2020-02-01,2940,2982,0.0142857142808552,42
وپاسار,2020-02-02,2927,2940,0.004441407583040175,13
وپاسار,2020-02-03,2988,2927,0.020414993299727246,61
وپاسار,2020-02-04,3091,2988,0.0333225493260037,103
وپاسار,2020-02-05,3238,3091,0.045398394056393336,147
وپاسار,2020-02-08,3324,3238,0.02587244283216834,86
وپاسار,2020-02-09,3189,3324,0.04233301974213452,135
وپاسار,2020-02-10,3043,3189,0.04797896810779528,146
وپاسار,2020-02-12,3182,3043,0.04368321808809453,139
وپاسار,2020-02-15,3132,3182,0.015964240097074,50
وپاسار,2020-02-16,3160,3132,0.008860759490866848,28
وپاسار,2020-02-17,3133,3160,0.008617938075768293,27
وپاسار,2020-02-18,3059,3133,0.0241909120548575,74
وپاسار,2020-02-19,3074,3059,0.004879635652283788,15
وپاسار,2020-02-22,2948,3074,0.042740841233805685,126
وپاسار,2020-02-23,3085,2948,0.044408427862428386,137
وپاسار,2020-02-24,3068,3085,0.005541069098585049,17
وپاسار,2020-02-25,3205,3068,0.04274570981505594,137
وپاسار,2020-02-26,3245,3205,0.012326656390654344,40
وپاسار,2020-02-29,3084,3245,0.05220492864714497,161
وپاسار,2020-03-01,3123,3084,0.012487992311082935,39
وپاسار,2020-03-02,3241,3123,0.03640851587892363,118
وپاسار,2020-03-03,3398,3241,0.046203649191817645,157
وپاسار,2020-03-04,3543,3398,0.040925769110661654,145
وپاسار,2020-03-07,3561,3543,0.005054759897485325,18
وپاسار,2020-03-09,3402,3561,0.04673721339014191,159
وپاسار,2020-03-10,3310,3402,0.027794561925137594,92
وپاسار,2020-03-11,3456,3310,0.04224537035814659,146
وپاسار,2020-03-14,3393,3456,0.018567639251822095,63
وپاسار,2020-03-15,3230,3393,0.05046439626920607,163
وپاسار,2020-03-16,3318,3230,0.02652200119755214,88
وپاسار,2020-03-17,3342,3318,0.007181328543632158,24
وپاسار,2020-03-18,3484,3342,0.04075774970127505,142
وپاسار,2020-03-24,3608,3484,0.03436807094391129,124
وپاسار,2020-03-25,3788,3608,0.04751847939611445,180
وپاسار,2020-03-28,3977,3788,0.047523258725792494,189
وپاسار,2020-03-29,4138,3977,0.038907684862516265,161
وپاسار,2020-03-30,4162,4138,0.005766458432059957,24
وپاسار,2020-04-04,4366,4162,0.046724690781785455,204
وپاسار,2020-04-05,4436,4366,0.01577998196217764,70
وپاسار,2020-04-06,4297,4436,0.032348149864475644,139
وپاسار,2020-04-07,4436,4297,0.031334535610609886,139
وپاسار,2020-04-08,4437,4436,2.2537750727397396e-4,1
وپاسار,2020-04-11,4441,4437,9.006980407789465e-4,4
وپاسار,2020-04-12,4620,4441,0.03874458873620247,179
وپاسار,2020-04-13,4739,4620,0.025110782860284703,119
وپاسار,2020-04-14,4895,4739,0.03186925433465388,156
وپاسار,2020-04-15,5135,4895,0.046738072045425884,240
وپاسار,2020-04-18,5391,5135,0.04748655165136587,256
وپاسار,2020-04-19,5593,5391,0.03611657428283272,202
وپاسار,2020-04-20,5849,5593,0.04376816549089277,256
وپاسار,2020-04-21,6141,5849,0.047549259070583084,292
وپاسار,2020-04-22,6377,6141,0.03700799748517986,236
وپاسار,2020-04-27,7021,6377,0.09172482551036536,644
وپاسار,2020-04-28,7359,7021,0.04593015354723058,338
وپاسار,2020-04-29,7726,7359,0.047501941490098114,367
وپاسار,2020-05-02,8112,7726,0.04758382642411442,386
وپاسار,2020-05-03,8517,8112,0.047551954908118824,405
وپاسار,2020-05-04,8942,8517,0.04752851710495096,425
وپاسار,2020-05-05,9254,8942,0.033715150201673316,312
وپاسار,2020-05-06,9531,9254,0.02906305738861997,277
وپاسار,2020-05-09,10007,9531,0.04756670330293128,476
وپاسار,2020-05-10,10507,10007,0.0475873227326937,500
وپاسار,2020-05-11,10749,10507,0.02251372220462241,242
وپاسار,2020-05-13,10265,10749,0.04715051144207009,484
وپاسار,2020-05-16,9752,10265,0.05260459392405613,513
وپاسار,2020-05-17,9459,9752,0.03097579024939467,293
وپاسار,2020-05-18,9382,9459,0.008207205285844467,77
وپاسار,2020-05-19,9071,9382,0.03428508433091334,311
وپاسار,2020-05-20,8675,9071,0.04564841498032871,396
وپاسار,2020-05-23,8598,8675,0.008955571061996327,77
وپاسار,2020-05-26,8377,8598,0.02638175957665253,221
وپاسار,2020-05-27,8680,8377,0.03490783409736085,303
وپاسار,2020-05-30,9100,8680,0.046153846148774304,420
وپاسار,2020-05-31,8890,9100,0.02362204724143734,210
وپاسار,2020-06-01,9049,8890,0.01757100231875666,159
وپاسار,2020-06-02,9465,9049,0.04395139988970402,416
وپاسار,2020-06-06,9857,9465,0.03976869229585384,392
وپاسار,2020-06-07,10333,9857,0.04606600212464279,476
وپاسار,2020-06-08,10057,10333,0.02744357163891383,276
وپاسار,2020-06-09,9832,10057,0.022884458907355118,225
وپاسار,2020-06-10,10003,9832,0.017094871536829464,171
وپاسار,2020-06-13,10140,10003,0.013510848124900311,137
وپاسار,2020-06-14,10640,10140,0.04699248119859093,500
وپاسار,2020-06-15,11160,10640,0.04659498207467787,520
وپاسار,2020-06-16,11710,11160,0.046968403070284506,550
وپاسار,2020-06-20,12290,11710,0.04719283970323899,580
وپاسار,2020-06-21,12850,12290,0.04357976653357356,560
وپاسار,2020-06-22,13350,12850,0.03745318351779377,500
وپاسار,2020-06-27,14010,13350,0.0471092077054169,660
وپاسار,2020-06-28,13880,14010,0.009365994235636456,130
وپاسار,2020-06-29,13250,13880,0.04754716980773229,630
وپاسار,2020-06-30,13910,13250,0.0474478792201691,660
وپاسار,2020-07-01,14600,13910,0.04726027396936573,690
وپاسار,2020-07-04,14440,14600,0.011080332409204963,160
وپاسار,2020-07-05,14610,14440,0.011635865844514998,170
وپاسار,2020-07-06,15330,14610,0.046966731895175036,720
وپاسار,2020-07-07,15170,15330,0.010547132497656748,160
وپاسار,2020-07-08,14550,15170,0.04261168384586861,620
وپاسار,2020-07-11,14000,14550,0.03928571428290816,550
وپاسار,2020-07-12,14530,14000,0.03647625601951299,530
وپاسار,2020-07-13,13880,14530,0.04682997117818228,650
وپاسار,2020-07-14,13970,13880,0.00644237652065552,90
وپاسار,2020-07-15,14160,13970,0.013418079095097592,190
وپاسار,2020-07-18,13960,14160,0.014326647563443649,200
وپاسار,2020-07-19,14550,13960,0.04054982817590723,590
وپاسار,2020-07-27,12080,14550,0.20447019865857033,2470
وپاسار,2020-07-28,11810,12080,0.022861981369783065,270
وپاسار,2020-07-29,11360,11810,0.039612676052850994,450
وپاسار,2020-08-01,11910,11360,0.04617968093650884,550
وپاسار,2020-08-02,12460,11910,0.044141252002877905,550
وپاسار,2020-08-03,12630,12460,0.01346001583424703,170
وپاسار,2020-08-04,13260,12630,0.04751131221361151,630
وپاسار,2020-08-05,13920,13260,0.04741379310004211,660
وپاسار,2020-08-09,14580,13920,0.04526748970882939,660
وپاسار,2020-08-10,13950,14580,0.045161290319343274,630
وپاسار,2020-08-11,13280,13950,0.05045180722511658,670
وپاسار,2020-08-12,12960,13280,0.02469135802278616,320
وپاسار,2020-08-15,12440,12960,0.04180064308345654,520
وپاسار,2020-08-16,11840,12440,0.05067567567139564,600
وپاسار,2020-08-17,11550,11840,0.025108225106051235,290
وپاسار,2020-08-18,11990,11550,0.036697247703361364,440
وپاسار,2020-08-19,11690,11990,0.02566295979250103,300
وپاسار,2020-08-22,11220,11690,0.041889483062220186,470
وپاسار,2020-08-23,10770,11220,0.04178272980113438,450
وپاسار,2020-08-24,10240,10770,0.05175781249494552,530
وپاسار,2020-08-25,10700,10240,0.04299065420158966,460
وپاسار,2020-08-26,11230,10700,0.047195013352876666,530
وپاسار,2020-08-31,11280,11230,0.004432624113082214,50
وپاسار,2020-09-01,10850,11280,0.03963133640187729,430
وپاسار,2020-09-02,10440,10850,0.03927203064757931,410
وپاسار,2020-09-05,10590,10440,0.01416430594767098,150
وپاسار,2020-09-06,10620,10590,0.0028248587567961526,30
وپاسار,2020-09-07,10180,10620,0.04322200392502731,440
وپاسار,2020-09-08,10010,10180,0.016983016981320376,170
وپاسار,2020-09-09,9750,10010,0.026666666663931624,260
وخارزم,2018-01-15,913,911,0.002190580501434194,2
وخارزم,2018-01-16,909,913,0.004400440039163432,4
وخارزم,2018-01-17,903,909,0.006644518265066979,6
وخارزم,2018-01-20,899,903,0.004449388204171982,4
وخارزم,2018-01-21,890,899,0.010112359539199596,9
وخارزم,2018-01-22,889,890,0.0011248593913106193,1
وخارزم,2018-01-23,889,889,0,0
وخارزم,2018-01-24,888,889,0.001126126124857966,1
وخارزم,2018-01-27,883,888,0.0056625141498725775,5
وخارزم,2018-01-28,870,883,0.014942528718456864,13
وخارزم,2018-01-29,865,870,0.0057803468141267664,5
وخارزم,2018-01-30,859,865,0.006984866115267909,6
وخارزم,2018-01-31,859,859,0,0
وخارزم,2018-02-03,867,859,0.00922722028924196,8
وخارزم,2018-02-04,878,867,0.012528473789830895,11
وخارزم,2018-02-05,875,878,0.003428571424653061,3
وخارزم,2018-02-06,871,875,0.004592422497597678,4
وخارزم,2018-02-07,868,871,0.0034562211941748604,3
وخارزم,2018-02-10,866,868,0.0023094688195040777,2
وخارزم,2018-02-12,861,866,0.005807200922407432,5
وخارزم,2018-02-13,852,861,0.010563380269291807,9
وخارزم,2018-02-14,840,852,0.014285714268707483,12
وخارزم,2018-02-17,822,840,0.02189781019233843,18
وخارزم,2018-02-18,821,822,0.0012180267951059356,1
وخارزم,2018-02-19,819,821,0.002442002439020754,2
وخارزم,2018-02-21,813,819,0.007380073791660426,6
وخارزم,2018-02-24,811,813,0.002466091242335276,2
وخارزم,2018-02-25,806,811,0.006203473937712811,5
وخارزم,2018-02-26,805,806,0.0012422360233015702,1
وخارزم,2018-02-27,803,805,0.0024906600218049064,2
وخارزم,2018-02-28,802,803,0.0012468827914627397,1
وخارزم,2018-03-03,802,802,0,0
وخارزم,2018-03-04,805,802,0.0037267080699047105,3
وخارزم,2018-03-05,798,805,0.00877192981356901,7
وخارزم,2018-03-06,791,798,0.008849557510936084,7
وخارزم,2018-03-07,784,791,0.008928571417182944,7
وخارزم,2018-03-10,771,784,0.01686121917398026,13
وخارزم,2018-03-11,762,771,0.011811023606547214,9
وخارزم,2018-03-12,765,762,0.003921568622324747,3
وخارزم,2018-03-13,787,765,0.02795425663538214,22
وخارزم,2018-03-14,789,787,0.0025348542426681187,2
وخارزم,2018-03-17,809,789,0.02472187883223501,20
وخارزم,2018-03-18,838,809,0.034606205209300474,29
وخارزم,2018-03-19,862,838,0.027842227345890688,24
وخارزم,2018-03-25,861,862,0.0011614401844814864,1
وخارزم,2018-03-26,857,861,0.004667444568649423,4
وخارزم,2018-03-27,851,857,0.007050528781374232,6
وخارزم,2018-03-28,849,851,0.0023557126002877356,2
وخارزم,2018-04-03,845,849,0.004733727805048843,4
وخارزم,2018-04-04,843,845,0.002372479237992314,2
وخارزم,2018-04-07,823,843,0.024301336543983795,20
وخارزم,2018-04-08,801,823,0.027465667880816894,22
وخارزم,2018-04-09,792,801,0.011363636349288338,9
وخارزم,2018-04-10,781,792,0.01408450702421958,11
وخارزم,2018-04-11,771,781,0.012970168595369432,10
وخارزم,2018-04-15,755,771,0.021192052952063507,16
وخارزم,2018-04-16,745,755,0.013422818773929103,10
وخارزم,2018-04-17,742,745,0.004043126679187161,3
وخارزم,2018-04-18,729,742,0.017832647437815298,13
وخارزم,2018-04-21,727,729,0.0027510316330797363,2
وخارزم,2018-04-22,726,727,0.0013774104664222996,1
وخارزم,2018-04-23,728,726,0.0027472527434790482,2
وخارزم,2018-04-24,729,728,0.0013717421106011769,1
وخارزم,2018-04-25,722,729,0.009695290845297381,7
وخارزم,2018-04-28,721,722,0.0013869625500874305,1
وخارزم,2018-04-29,712,721,0.012640449420448807,9
وخارزم,2018-04-30,705,712,0.0099290780001006,7
وخارزم,2018-05-01,704,705,0.0014204545434368544,1
وخارزم,2018-05-05,685,704,0.02773722623687996,19
وخارزم,2018-05-06,673,685,0.01783060918598721,12
وخارزم,2018-05-07,674,673,0.001483679523021247,1
وخارزم,2018-05-08,681,674,0.0102790014533348,7
وخارزم,2018-05-09,672,681,0.013392857122927296,9
وخارزم,2018-05-12,673,672,0.0014858840988322673,1
وخارزم,2018-05-13,680,673,0.010294117631920415,7
وخارزم,2018-05-14,713,680,0.046283309893010785,33
وخارزم,2018-05-15,720,713,0.009722222208719137,7
وخارزم,2018-05-16,717,720,0.004184100412574477,3
وخارزم,2018-05-19,699,717,0.025751072924533516,18
وخارزم,2018-05-20,702,699,0.004273504267416661,3
وخارزم,2018-05-21,700,702,0.0028571428530612245,2
وخارزم,2018-05-22,699,700,0.0014306151624740842,1
وخارزم,2018-05-23,699,699,0,0
وخارزم,2018-05-26,700,699,0.0014285714265306123,1
وخارزم,2018-05-27,704,700,0.0056818181737474174,4
وخارزم,2018-05-28,703,704,0.0014224751046621976,1
وخارزم,2018-05-29,698,703,0.007163323771972315,5
وخارزم,2018-05-30,695,698,0.00431654675637907,3
وخارزم,2018-06-02,689,695,0.008708272846577252,6
وخارزم,2018-06-03,689,689,0,0
وخارزم,2018-06-09,688,689,0.0014534883699803948,1
وخارزم,2018-06-10,691,688,0.004341534002400096,3
وخارزم,2018-06-11,694,691,0.004322766564376417,3
وخارزم,2018-06-12,696,694,0.002873563214262122,2
وخارزم,2018-06-13,723,696,0.03734439828859696,27
وخارزم,2018-06-17,759,723,0.04743082997703448,36
وخارزم,2018-06-18,750,759,0.011999999984,9
وخارزم,2018-06-19,758,750,0.010554089695838932,8
وخارزم,2018-06-20,759,758,0.0013175230549176244,1
وخارزم,2018-06-23,787,759,0.03557814480866818,28
وخارزم,2018-06-24,826,787,0.047215496310877125,39
وخارزم,2018-06-25,867,826,0.04728950398236505,41
وخارزم,2018-06-26,838,867,0.034606205209300474,29
وخارزم,2018-06-27,805,838,0.040993788768951815,33
وخارزم,2018-06-30,803,805,0.0024906600218049064,2
وخارزم,2018-07-01,768,803,0.04557291660732693,35
وخارزم,2018-07-02,767,768,0.0013037809630980692,1
وخارزم,2018-07-03,804,767,0.04601990044027376,37
وخارزم,2018-07-04,843,804,0.04626334514085013,39
وخارزم,2018-07-07,842,843,0.0011876484546464983,1
وخارزم,2018-07-08,823,842,0.023086269716784607,19
وخارزم,2018-07-14,791,823,0.04045512004999353,32
وخارزم,2018-07-15,785,791,0.0076433120921741244,6
وخارزم,2018-07-16,766,785,0.024804177513310474,19
وخارزم,2018-07-17,754,766,0.01591511934228764,12
وخارزم,2018-07-18,750,754,0.005333333326222222,4
وخارزم,2018-07-21,766,750,0.02088772843226145,16
وخارزم,2018-07-22,758,766,0.010554089695838932,8
وخارزم,2018-07-23,767,758,0.011734028667882623,9
وخارزم,2018-07-24,767,767,0,0
وخارزم,2018-07-25,764,767,0.003926701565540967,3
وخارزم,2018-07-28,769,764,0.006501950576720481,5
وخارزم,2018-07-29,743,769,0.03499327047780179,26
وخارزم,2018-07-30,751,743,0.010652463367972752,8
وخارزم,2018-07-31,779,751,0.03594351728376956,28
وخارزم,2018-08-01,777,779,0.0025740025706898293,2
وخارزم,2018-08-04,754,777,0.030503978739384645,23
وخارزم,2018-08-05,768,754,0.018229166642930773,14
وخارزم,2018-08-06,804,768,0.044776119347293385,36
وخارزم,2018-08-07,843,804,0.04626334514085013,39
وخارزم,2018-08-08,883,843,0.04530011319898062,40
وخارزم,2018-08-11,879,883,0.004550625705858219,4
وخارزم,2018-08-12,871,879,0.009184844995195356,8
وخارزم,2018-08-13,865,871,0.00693641617695212,6
وخارزم,2018-08-14,856,865,0.010514018679306052,9
وخارزم,2018-08-15,894,856,0.0425055927936179,38
وخارزم,2018-08-18,900,894,0.006666666659259259,6
وخارزم,2018-08-19,867,900,0.03806228369312309,33
وخارزم,2018-08-20,877,867,0.011402508538879693,10
وخارزم,2018-08-21,868,877,0.01036866358252458,9
وخارزم,2018-08-25,901,868,0.03662597110252389,33
وخارزم,2018-08-26,902,901,0.0011086474488817657,1
وخارزم,2018-08-27,901,902,0.0011098779121976937,1
وخارزم,2018-08-28,880,901,0.023863636336518595,21
وخارزم,2018-08-29,901,880,0.023307436156151568,21
وخارزم,2018-09-01,939,901,0.040468583556476485,38
وخارزم,2018-09-02,900,939,0.04333333328518518,39
وخارزم,2018-09-03,886,900,0.015801354383971383,14
وخارزم,2018-09-04,887,886,0.0011273957146252585,1
وخارزم,2018-09-05,875,887,0.013714285698612244,12
وخارزم,2018-09-08,896,875,0.023437499973842077,21
وخارزم,2018-09-09,915,896,0.020765027299710352,19
وخارزم,2018-09-10,960,915,0.04687499995117188,45
وخارزم,2018-09-11,1008,960,0.0476190475718065,48
وخارزم,2018-09-12,1058,1008,0.04725897916138092,50
وخارزم,2018-09-15,1043,1058,0.014381591549010937,15
وخارزم,2018-09-16,1079,1043,0.033364226104389036,36
وخارزم,2018-09-17,1098,1079,0.01730418941957724,19
وخارزم,2018-09-18,1082,1098,0.01478743067025191,16
وخارزم,2018-09-22,1105,1082,0.020814479619172415,23
وخارزم,2018-09-23,1121,1105,0.01427297054926586,16
وخارزم,2018-09-24,1177,1121,0.047578589594240786,56
وخارزم,2018-09-25,1235,1177,0.046963562715009254,58
وخارزم,2018-09-26,1293,1235,0.044856921852392165,58
وخارزم,2018-09-29,1357,1293,0.047162859213586684,64
وخارزم,2018-09-30,1495,1357,0.09230769224594802,138
وخارزم,2018-10-01,1486,1495,0.006056527586772188,9
وخارزم,2018-10-02,1422,1486,0.04500703231715398,64
وخارزم,2018-10-03,1352,1422,0.05177514789069885,70
وخارزم,2018-10-06,1294,1352,0.044822256534140445,58
وخارزم,2018-10-07,1230,1294,0.05203252028290038,64
وخارزم,2018-10-08,1173,1230,0.048593350342205154,57
وخارزم,2018-10-09,1221,1173,0.03931203927984272,48
وخارزم,2018-10-10,1164,1221,0.0489690721228788,57
وخارزم,2018-10-13,1110,1164,0.04864864860482103,54
وخارزم,2018-10-14,1093,1110,0.015553522401140418,17
وخارزم,2018-10-15,1120,1093,0.02410714283561862,27
وخارزم,2018-10-16,1114,1120,0.0053859964045009,6
وخارزم,2018-10-21,1111,1114,0.002700270024572214,3
وخارزم,2018-10-22,1098,1111,0.011839708550237058,13
وخارزم,2018-10-23,1052,1098,0.043726235699879996,46
وخارزم,2018-10-24,1005,1052,0.046766169107695356,47
وخارزم,2018-10-27,968,1005,0.038223140456381054,37
وخارزم,2018-10-28,992,968,0.024193548362708116,24
وخارزم,2018-10-29,1041,992,0.047070124834706885,49
وخارزم,2018-10-31,1092,1041,0.04670329666052811,51
وخارزم,2018-11-03,1093,1092,9.149130824200245e-4,1
وخارزم,2018-11-04,1068,1093,0.0234082396784567,25
وخارزم,2018-11-05,1101,1068,0.02997275201637352,33
وخارزم,2018-11-06,1139,1101,0.03336259874156049,38
وخارزم,2018-11-10,1131,1139,0.007073386377477111,8
وخارزم,2018-11-11,1082,1131,0.04528650642764648,49
وخارزم,2018-11-12,1097,1082,0.013673655411418727,15
وخارزم,2018-11-13,1084,1097,0.011992619915135958,13
وخارزم,2018-11-14,1051,1084,0.03139866790542467,33
وخارزم,2018-11-17,1013,1051,0.037512339548358996,38
وخارزم,2018-11-18,973,1013,0.041109969125272386,40
وخارزم,2018-11-19,982,973,0.00916496944076887,9
وخارزم,2018-11-20,959,982,0.023983315929110204,23
وخارزم,2018-11-21,998,959,0.03907815627346878,39
وخارزم,2018-11-24,990,998,0.008080808072645648,8
وخارزم,2018-11-26,947,990,0.045406546942548524,43
وخارزم,2018-11-27,953,947,0.0062959076534145775,6
وخارزم,2018-11-28,919,953,0.03699673554189691,34
وخارزم,2018-12-01,878,919,0.046697038671187886,41
وخارزم,2018-12-02,899,878,0.023359288071902906,21
وخارزم,2018-12-03,915,899,0.017486338778703456,16
وخارزم,2018-12-04,894,915,0.023489932859630948,21
وخارزم,2018-12-05,914,894,0.021881838050457507,20
وخارزم,2018-12-08,906,914,0.008830022065309027,8
وخارزم,2018-12-09,917,906,0.01199563793675503,11
وخارزم,2018-12-10,917,917,0,0
وخارزم,2018-12-11,933,917,0.017148981760826385,16
وخارزم,2018-12-12,941,933,0.008501594039849528,8
وخارزم,2018-12-15,969,941,0.028895768804029134,28
وخارزم,2018-12-16,1006,969,0.03677932401910604,37
وخارزم,2018-12-17,971,1006,0.03604531407204396,35
وخارزم,2018-12-18,951,971,0.021030494194500007,20
وخارزم,2018-12-19,947,951,0.004223864831864979,4
وخارزم,2018-12-22,980,947,0.03367346935339442,33
وخارزم,2018-12-23,1003,980,0.02293120635799481,23
وخارزم,2018-12-24,1005,1003,0.0019900497492636323,2
وخارزم,2018-12-25,1039,1005,0.03272377282702235,34
وخارزم,2018-12-26,1049,1039,0.00953288845611736,10
وخارزم,2018-12-29,1051,1049,0.0019029495700257377,2
وخارزم,2018-12-30,1063,1051,0.011288805257489364,12
وخارزم,2018-12-31,1047,1063,0.015281757387505483,16
وخارزم,2019-01-01,1088,1047,0.03768382349477589,41
وخارزم,2019-01-02,1078,1088,0.009276437839261189,10
وخارزم,2019-01-05,1054,1078,0.02277039846036964,24
وخارزم,2019-01-06,1067,1054,0.012183692584645085,13
وخارزم,2019-01-07,1049,1067,0.017159199221011247,18
وخارزم,2019-01-08,1027,1049,0.021421616337466778,22
وخارزم,2019-01-09,1033,1027,0.005808325260592133,6
وخارزم,2019-01-12,1031,1033,0.0019398642076237978,2
وخارزم,2019-01-13,1051,1031,0.019029495700257377,20
وخارزم,2019-01-14,1064,1051,0.012218045101298829,13
وخارزم,2019-01-15,1058,1064,0.00567107749936571,6
وخارزم,2019-01-16,1098,1058,0.03642987246226787,40
وخارزم,2019-01-19,1076,1098,0.020446096635273144,22
وخارزم,2019-01-20,1068,1076,0.007490636697106145,8
وخارزم,2019-01-21,1027,1068,0.03992210317436991,41
وخارزم,2019-01-22,1048,1027,0.020038167919810907,21
وخارزم,2019-01-23,1051,1048,0.0028544243550386065,3
وخارزم,2019-01-26,1047,1051,0.0038204393468763706,4
وخارزم,2019-01-27,1074,1047,0.025139664781061763,27
وخارزم,2019-01-28,1037,1074,0.035679845674368514,37
وخارزم,2019-01-29,1037,1037,0,0
وخارزم,2019-01-30,1031,1037,0.0058195926228713935,6
وخارزم,2019-02-02,1020,1031,0.010784313714917339,11
وخارزم,2019-02-03,976,1020,0.04508196716692421,44
وخارزم,2019-02-04,986,976,0.010141987819328614,10
وخارزم,2019-02-05,987,986,0.0010131712249106676,1
وخارزم,2019-02-06,982,987,0.005091649689316039,5
وخارزم,2019-02-10,976,982,0.0061475409773078474,6
وخارزم,2019-02-12,966,976,0.010351966862989682,10
وخارزم,2019-02-13,936,966,0.03205128201703923,30
وخارزم,2019-02-16,927,936,0.009708737853604382,9
وخارزم,2019-02-17,908,927,0.020925110109113316,19
وخارزم,2019-02-18,924,908,0.01731601729727704,16
وخارزم,2019-02-19,917,924,0.007633587777935019,7
وخارزم,2019-02-27,993,917,0.07653575017468706,76
وخارزم,2019-03-02,976,993,0.017418032769038902,17
وخارزم,2019-03-03,946,976,0.03171247353941599,30
وخارزم,2019-03-04,931,946,0.01611170782372534,15
وخارزم,2019-03-05,919,931,0.013057671367728323,12
وخارزم,2019-03-06,917,919,0.0021810250794100055,2
وخارزم,2019-03-09,914,917,0.003282275707568626,3
وخارزم,2019-03-10,926,914,0.012958963268942804,12
وخارزم,2019-03-11,934,926,0.008565310483334785,8
وخارزم,2019-03-12,923,934,0.011917659792071874,11
وخارزم,2019-03-13,923,923,0,0
وخارزم,2019-03-16,917,923,0.006543075238230016,6
وخارزم,2019-03-17,918,917,0.0010893246175497553,1
وخارزم,2019-03-18,926,918,0.00863930884596187,8
وخارزم,2019-03-19,933,926,0.007502679520361544,7
وخارزم,2019-03-25,955,933,0.02303664919053754,22
وخارزم,2019-03-26,977,955,0.02251791195238699,22
وخارزم,2019-03-27,967,977,0.010341261623225169,10
وخارزم,2019-03-30,994,967,0.02716297783987628,27
وخارزم,2019-03-31,999,994,0.00500500499999499,5
وخارزم,2019-04-06,1027,999,0.02726387533859408,28
وخارزم,2019-04-07,1074,1027,0.04376163869295936,47
وخارزم,2019-04-08,1053,1074,0.0199430199240807,21
وخارزم,2019-04-09,1044,1053,0.008620689646915047,9
وخارزم,2019-04-10,1086,1044,0.03867403311355982,42
وخارزم,2019-04-13,1094,1086,0.007312614252913514,8
وخارزم,2019-04-14,1086,1094,0.007366482497820918,8
وخارزم,2019-04-15,1139,1086,0.0465320456132291,53
وخارزم,2019-04-16,1160,1139,0.018103448260255648,21
وخارزم,2019-04-17,1122,1160,0.03386809266143664,38
وخارزم,2019-04-20,1172,1122,0.0426621160045545,50
وخارزم,2019-04-22,1143,1172,0.025371828499237244,29
وخارزم,2019-04-23,1116,1143,0.024193548365417965,27
وخارزم,2019-04-24,1136,1116,0.017605633787318983,20
وخارزم,2019-04-27,1145,1136,0.007860262001868765,9
وخارزم,2019-04-28,1139,1145,0.005267778748667446,6
وخارزم,2019-04-29,1140,1139,8.771929816866728e-4,1
وخارزم,2019-04-30,1130,1140,0.008849557514292426,10
وخارزم,2019-05-01,1141,1130,0.00964066607393456,11
وخارزم,2019-05-04,1193,1141,0.0435875942635477,52
وخارزم,2019-05-05,1242,1193,0.03945249594246981,49
وخارزم,2019-05-06,1192,1242,0.04194630868964235,50
وخارزم,2019-05-07,1140,1192,0.04561403504770698,52
وخارزم,2019-05-08,1121,1140,0.01694915252725321,19
وخارزم,2019-05-11,1091,1121,0.027497708499085508,30
وخارزم,2019-05-12,1040,1091,0.049038461491309165,51
وخارزم,2019-05-13,1057,1040,0.016083254478634575,17
وخارزم,2019-05-14,1088,1057,0.028492647032635432,31
وخارزم,2019-05-15,1067,1088,0.019681349559811292,21
وخارزم,2019-05-18,1120,1067,0.04732142852917729,53
وخارزم,2019-05-19,1176,1120,0.04761904757855523,56
وخارزم,2019-05-20,1233,1176,0.04622871042479423,57
وخارزم,2019-05-21,1291,1233,0.04492641359804305,58
وخارزم,2019-05-22,1305,1291,0.010727969340438336,14
وخارزم,2019-05-25,1266,1305,0.03080568717945838,39
وخارزم,2019-05-26,1321,1266,0.04163512487385683,55
وخارزم,2019-05-28,1387,1321,0.0475847151783816,66
وخارزم,2019-05-29,1438,1387,0.03546592487102508,51
وخارزم,2019-06-01,1381,1438,0.04127443878256738,57
وخارزم,2019-06-02,1403,1381,0.015680684236863373,22
وخارزم,2019-06-03,1365,1403,0.027838827818433092,38
وخارزم,2019-06-08,1321,1365,0.03330809989908546,44
وخارزم,2019-06-09,1332,1321,0.008258258252058365,11
وخارزم,2019-06-10,1322,1332,0.007564296514701742,10
وخارزم,2019-06-11,1305,1322,0.01302681991338941,17
وخارزم,2019-06-12,1362,1305,0.04185022023359014,57
وخارزم,2019-06-15,1340,1362,0.016417910435509022,22
وخارزم,2019-06-16,1394,1340,0.03873744617020269,54
وخارزم,2019-06-17,1357,1394,0.027266027982854803,37
وخارزم,2019-06-18,1410,1357,0.03758865245561088,53
وخارزم,2019-06-19,1351,1410,0.04367135451985836,59
وخارزم,2019-06-23,1382,1351,0.022431259028631505,31
وخارزم,2019-06-24,1375,1382,0.005090909087206611,7
وخارزم,2019-06-25,1348,1375,0.02002967357564564,27
وخارزم,2019-06-26,1337,1348,0.008227374713367708,11
وخارزم,2019-06-30,1399,1337,0.04431736951800045,62
وخارزم,2019-07-01,1395,1399,0.0028673835104893308,4
وخارزم,2019-07-02,1414,1395,0.013437057982010565,19
وخارزم,2019-07-03,1381,1414,0.02389572771622322,33
وخارزم,2019-07-06,1345,1381,0.026765799236605353,36
وخارزم,2019-07-07,1393,1345,0.03445800428251399,48
وخارزم,2019-07-08,1459,1393,0.04523646330004354,66
وخارزم,2019-07-09,1523,1459,0.04202232433222434,64
وخارزم,2019-07-10,1503,1523,0.0133067198846928,20
وخارزم,2019-07-13,1512,1503,0.005952380948444192,9
وخارزم,2019-07-14,1549,1512,0.02388637829316567,37
وخارزم,2019-07-15,1592,1549,0.027010050234290168,43
وخارزم,2019-07-16,1516,1592,0.050131926088303476,76
وخارزم,2019-07-17,1446,1516,0.04840940522240013,70
وخارزم,2019-07-20,1410,1446,0.02553191487550928,36
وخارزم,2019-07-21,1395,1410,0.01075268816433499,15
وخارزم,2019-07-22,1397,1395,0.001431639225890022,2
وخارزم,2019-07-23,1356,1397,0.030235988178292043,41
وخارزم,2019-07-24,1357,1356,7.369196752122919e-4,1
وخارزم,2019-07-27,1400,1357,0.030714285692346938,43
وخارزم,2019-07-28,1430,1400,0.020979020964350333,30
وخارزم,2019-07-29,1389,1430,0.029517638567661885,41
وخارزم,2019-07-30,1378,1389,0.00798258344848869,11
وخارزم,2019-07-31,1368,1378,0.007309941515124311,10
وخارزم,2019-08-03,1378,1368,0.007256894044080628,10
وخارزم,2019-08-04,1407,1378,0.020611229551804385,29
وخارزم,2019-08-05,1422,1407,0.010548523199332964,15
وخارزم,2019-08-06,1403,1422,0.013542409113654732,19
وخارزم,2019-08-07,1402,1403,7.132667612601521e-4,1
وخارزم,2019-08-10,1460,1402,0.03972602737005066,58
وخارزم,2019-08-11,1527,1460,0.04387688274795227,67
وخارزم,2019-08-13,1488,1527,0.026209677401740808,39
وخارزم,2019-08-14,1517,1488,0.019116677640661384,29
وخارزم,2019-08-17,1580,1517,0.039873417696282644,63
وخارزم,2019-08-18,1591,1580,0.006913890630475241,11
وخارزم,2019-08-19,1583,1591,0.00505369551165275,8
وخارزم,2019-08-21,1658,1583,0.04523522313315125,75
وخارزم,2019-08-24,1728,1658,0.0405092592358164,70
وخارزم,2019-08-25,1662,1728,0.03971119131184645,66
وخارزم,2019-08-26,1735,1662,0.04207492792963981,73
وخارزم,2019-08-27,1694,1735,0.024203069643327583,41
وخارزم,2019-08-28,1651,1694,0.02604482130463669,43
وخارزم,2019-08-31,1692,1651,0.02423167847267631,41
وخارزم,2019-09-01,1699,1692,0.004120070627357227,7
وخارزم,2019-09-02,1648,1699,0.030946601922969292,51
وخارزم,2019-09-03,1684,1648,0.02137767219633155,36
وخارزم,2019-09-04,1703,1684,0.01115678214259731,19
وخارزم,2019-09-07,1782,1703,0.04433221097399988,79
وخارزم,2019-09-08,1853,1782,0.03831624390808621,71
وخارزم,2019-09-11,1940,1853,0.0448453608016261,87
وخارزم,2019-09-14,1993,1940,0.026593075751834883,53
وخارزم,2019-09-15,1920,1993,0.038020833313530816,73
وخارزم,2019-09-16,1904,1920,0.008403361340124284,16
وخارزم,2019-09-17,1906,1904,0.0010493179427862969,2
وخارزم,2019-09-18,1815,1906,0.05013774101920785,91
وخارزم,2019-09-21,1836,1815,0.011437908490502227,21
وخارزم,2019-09-22,1844,1836,0.004338394791573538,8
وخارزم,2019-09-23,1859,1844,0.008068854218359948,15
وخارزم,2019-09-24,1834,1859,0.013631406753745143,25
وخارزم,2019-09-25,1873,1834,0.02082221034659786,39
وخارزم,2019-09-28,1962,1873,0.04536187561398477,89
وخارزم,2019-09-29,1942,1962,0.010298661168744252,20
وخارزم,2019-09-30,2006,1942,0.031904287122679814,64
وخارزم,2019-10-01,2077,2006,0.03418391909764857,71
وخارزم,2019-10-02,2055,2077,0.010705596101846427,22
وخارزم,2019-10-05,2113,2055,0.027449124454591044,58
وخارزم,2019-10-06,2023,2113,0.044488383566738315,90
وخارزم,2019-10-07,2035,2023,0.005896805893908203,12
وخارزم,2019-10-08,1949,2035,0.04412519238372232,86
وخارزم,2019-10-09,1879,1949,0.037253858415511515,70
وخارزم,2019-10-12,1907,1879,0.014682747763669245,28
وخارزم,2019-10-13,1894,1907,0.00686378035540455,13
وخارزم,2019-10-14,1802,1894,0.051054383989425974,92
وخارزم,2019-10-15,1801,1802,5.552470846445047e-4,1
وخارزم,2019-10-26,1614,1801,0.11586121430244038,187
وخارزم,2019-10-28,1667,1614,0.031793641252673276,53
وخارزم,2019-11-03,1722,1667,0.03193960509178884,55
وخارزم,2019-11-04,1654,1722,0.041112454630524514,68
وخارزم,2019-11-05,1636,1654,0.011002444981049849,18
وخارزم,2019-11-09,1651,1636,0.009085402780687217,15
وخارزم,2019-11-10,1613,1651,0.02355858647020546,38
وخارزم,2019-11-11,1609,1613,0.002486016157559965,4
وخارزم,2019-11-12,1651,1609,0.02543912778592421,42
وخارزم,2019-11-13,1675,1651,0.01432835820040098,24
وخارزم,2019-11-16,1665,1675,0.006006006002398795,10
وخارزم,2019-11-17,1586,1665,0.049810844861405516,79
وخارزم,2019-11-18,1603,1586,0.010605115401993066,17
وخارزم,2019-11-19,1632,1603,0.017769607832249013,29
وخارزم,2019-11-20,1632,1632,0,0
وخارزم,2019-11-23,1627,1632,0.003073140747957504,5
وخارزم,2019-11-24,1649,1627,0.01334141903375293,22
وخارزم,2019-11-25,1667,1649,0.010797840425436208,18
وخارزم,2019-11-26,1653,1667,0.00846944948065974,14
وخارزم,2019-11-27,1691,1653,0.022471910099070423,38
وخارزم,2019-11-30,1767,1691,0.04301075266383093,76
وخارزم,2019-12-01,1830,1767,0.03442622948938457,63
وخارزم,2019-12-02,1804,1830,0.014412416843452095,26
وخارزم,2019-12-03,1791,1804,0.007258514792150466,13
وخارزم,2019-12-04,1864,1791,0.03916309010774512,73
وخارزم,2019-12-07,1908,1864,0.023060796633615932,44
وخارزم,2019-12-08,1993,1908,0.042649272432188017,85
وخارزم,2019-12-09,2033,1993,0.01967535660616067,40
وخارزم,2019-12-10,2031,2033,9.84736582479204e-4,2
وخارزم,2019-12-11,2018,2031,0.006442021800573824,13
وخارزم,2019-12-14,1988,2018,0.015090543251966527,30
وخارزم,2019-12-15,1996,1988,0.004008016030056104,8
وخارزم,2019-12-16,1977,1996,0.009610520986539948,19
وخارزم,2019-12-17,2060,1977,0.04029126211636347,83
وخارزم,2019-12-18,2106,2060,0.02184235516531702,46
وخارزم,2019-12-22,2205,2106,0.04489795916331159,99
وخارزم,2019-12-23,2207,2205,9.062075211118227e-4,2
وخارزم,2019-12-24,2177,2207,0.013780431780532646,30
وخارزم,2019-12-25,2159,2177,0.008337193141112927,18
وخارزم,2019-12-28,2257,2159,0.043420469630739714,98
وخارزم,2019-12-29,2288,2257,0.013548951043029306,31
وخارزم,2019-12-30,2384,2288,0.040268456358947796,96
وخارزم,2019-12-31,2334,2384,0.021422450719184898,50
وخارزم,2020-01-01,2377,2334,0.018090029441274705,43
وخارزم,2020-01-04,2259,2377,0.05223550241158234,118
وخارزم,2020-01-05,2147,2259,0.05216581273769641,112
وخارزم,2020-01-07,2055,2147,0.04476885642590323,92
وخارزم,2020-01-08,2014,2055,0.020357497507270356,41
وخارزم,2020-01-11,2054,2014,0.019474196679905454,40
وخارزم,2020-01-12,2156,2054,0.0473098330021754,102
وخارزم,2020-01-13,2261,2156,0.04643962846243272,105
وخارزم,2020-01-14,2365,2261,0.04397463000254773,104
وخارزم,2020-01-15,2397,2365,0.013350020853838122,32
وخارزم,2020-01-18,2495,2397,0.03927855709848555,98
وخارزم,2020-01-19,2495,2495,0,0
وخارزم,2020-01-20,2465,2495,0.01217038539060025,30
وخارزم,2020-01-21,2421,2465,0.018174308129626473,44
وخارزم,2020-01-22,2533,2421,0.04421634423836702,112
وخارزم,2020-01-25,2659,2533,0.04738623540903113,126
وخارزم,2020-01-26,2775,2659,0.04180180178673809,116
وخارزم,2020-01-27,2888,2775,0.03912742380916641,113
وخارزم,2020-01-28,2966,2888,0.026298044495516506,78
وخارزم,2020-02-01,2962,2966,0.0013504388921841868,4
وخارزم,2020-02-02,2942,2962,0.006798096530660063,20
وخارزم,2020-02-03,3079,2942,0.04449496588356773,137
وخارزم,2020-02-04,3201,3079,0.038113089647574795,122
وخارزم,2020-02-05,3240,3201,0.012037037033321903,39
وخارزم,2020-02-08,3385,3240,0.04283604134628182,145
وخارزم,2020-02-09,3533,3385,0.041890744397993,148
وخارزم,2020-02-10,3420,3533,0.03304093566285353,113
وخارزم,2020-02-12,3447,3420,0.007832898170051379,27
وخارزم,2020-02-15,3369,3447,0.023152270696600693,78
وخارزم,2020-02-16,3376,3369,0.002073459715025634,7
وخارزم,2020-02-17,3254,3376,0.03749231713660347,122
وخارزم,2020-02-18,3105,3254,0.047987117536880154,149
وخارزم,2020-02-19,3181,3105,0.023891857898807968,76
وخارزم,2020-02-22,3136,3181,0.014349489791342637,45
وخارزم,2020-02-23,3265,3136,0.0395099540460919,129
وخارزم,2020-02-24,3248,3265,0.005233990146171801,17
وخارزم,2020-02-25,3275,3248,0.00824427480664297,27
وخارزم,2020-02-26,3303,3275,0.00847714198956187,28
وخارزم,2020-02-29,3158,3303,0.045915136147588624,145
وخارزم,2020-03-01,3217,3158,0.018340068380994695,59
وخارزم,2020-03-02,3315,3217,0.029562594259558796,98
وخارزم,2020-03-03,3480,3315,0.04741379308982362,165
وخارزم,2020-03-04,3651,3480,0.04683648314247152,171
وخارزم,2020-03-07,3831,3651,0.046985121365965776,180
وخارزم,2020-03-09,3657,3831,0.04757998358009845,174
وخارزم,2020-03-10,3706,3657,0.0132218024788932,49
وخارزم,2020-03-11,3884,3706,0.04582904221271137,178
وخارزم,2020-03-14,3883,3884,2.57532835370195e-4,1
وخارزم,2020-03-15,3971,3883,0.022160664814363972,88
وخارزم,2020-03-16,4169,3971,0.047493403682539355,198
وخارزم,2020-03-17,4372,4169,0.04643183896467707,203
وخارزم,2020-03-18,4590,4372,0.04749455336655892,218
وخارزم,2020-03-24,4819,4590,0.04752023240350275,229
وخارزم,2020-03-25,5059,4819,0.047440205564846766,240
وخارزم,2020-03-28,5311,5059,0.04744869138628343,252
وخارزم,2020-03-29,5576,5311,0.04752510759549406,265
وخارزم,2020-03-30,5793,5576,0.037459002237621435,217
وخارزم,2020-04-04,6082,5793,0.04751726405006293,289
وخارزم,2020-04-05,6386,6082,0.047604134035765085,304
وخارزم,2020-04-06,6694,6386,0.046011353443977984,308
وخارزم,2020-04-07,6668,6694,0.00389922015538404,26
وخارزم,2020-04-12,7342,6668,0.09180059927924263,674
وخارزم,2020-04-13,7661,7342,0.041639472648265306,319
وخارزم,2020-04-14,7795,7661,0.017190506732881267,134
وخارزم,2020-04-15,8184,7795,0.047531769300154965,389
وخارزم,2020-04-18,8593,8184,0.0475968811768187,409
وخارزم,2020-04-19,8980,8593,0.043095768369365725,387
وخارزم,2020-04-20,9418,8980,0.04650668931338854,438
وخارزم,2020-04-21,9823,9418,0.04122976686946658,405
وخارزم,2020-04-22,10225,9823,0.039315403419137855,402
وخارزم,2020-04-25,10736,10225,0.04759687033833859,511
وخارزم,2020-04-26,11272,10736,0.047551454928357745,536
وخارزم,2020-05-02,14562,11272,0.2259305040361262,3290
وخارزم,2020-05-03,15281,14562,0.04705189450644252,719
وخارزم,2020-05-04,14743,15281,0.036491894455911826,538
وخارزم,2020-05-05,14267,14743,0.033363706453118126,476
وخارزم,2020-05-06,13554,14267,0.05260439722203007,713
وخارزم,2020-05-09,13295,13554,0.019481007896240615,259
وخارزم,2020-05-10,12896,13295,0.030939826300330348,399
وخارزم,2020-05-11,12008,12896,0.07395069952748579,888
وخارزم,2020-05-12,11742,12008,0.022653721680918604,266
وخارزم,2020-05-13,12013,11742,0.02255889452904696,271
وخارزم,2020-05-18,13142,12013,0.08590777658758882,1129
وخارزم,2020-05-19,12849,13142,0.022803330996746567,293
وخارزم,2020-05-20,12214,12849,0.051989520218438716,635
وخارزم,2020-05-23,11056,12214,0.10473950795000547,1158
وخارزم,2020-05-26,10504,11056,0.05255140898204956,552
وخارزم,2020-05-27,10222,10504,0.02758755624852401,282
وخارزم,2020-05-30,10705,10222,0.045119103218578316,483
وخارزم,2020-05-31,10363,10705,0.03300202643703541,342
وخارزم,2020-06-01,10159,10363,0.02008071660398851,204
وخارزم,2020-06-02,10582,10159,0.03997353996976247,423
وخارزم,2020-06-06,11111,10582,0.047610476100476064,529
وخارزم,2020-06-07,11666,11111,0.047574147090041645,555
وخارزم,2020-06-08,12051,11666,0.03194755621674985,385
وخارزم,2020-06-09,12081,12051,0.0024832381423323204,30
وخارزم,2020-06-10,11829,12081,0.021303575955591885,252
وخارزم,2020-06-13,11970,11829,0.011779448620569804,141
وخارزم,2020-06-14,11500,11970,0.04086956521383743,470
وخارزم,2020-06-15,11990,11500,0.04086738948783424,490
وخارزم,2020-06-16,12560,11990,0.04538216560148231,570
وخارزم,2020-06-20,13180,12560,0.047040971164867905,620
وخارزم,2020-06-21,13170,13180,7.593014426150871e-4,10
وخارزم,2020-06-22,12850,13170,0.024902723733470605,320
وخارزم,2020-06-23,12980,12850,0.010015408319721463,130
وخارزم,2020-06-24,12420,12980,0.04508856682406694,560
وخارزم,2020-06-27,12970,12420,0.04240555126889703,550
وخارزم,2020-06-28,13610,12970,0.04702424687384098,640
وخارزم,2020-07-12,17260,13610,0.21147161064823455,3650
وخارزم,2020-07-13,16890,17260,0.021906453521497546,370
وخارزم,2020-07-14,17640,16890,0.04251700680031083,750
وخارزم,2020-07-15,17670,17640,0.0016977928691738657,30
وخارزم,2020-07-18,16960,17670,0.041863207544701464,710
وخارزم,2020-07-19,17210,16960,0.01452643811652955,250
وخارزم,2020-07-20,17350,17210,0.008069164264664601,140
وخارزم,2020-07-21,16550,17350,0.048338368577139676,800
وخارزم,2020-07-22,15730,16550,0.052129688490010824,820
وخارزم,2020-07-25,16420,15730,0.04202192447977942,690
وخارزم,2020-07-26,15820,16420,0.0379266750924193,600
وخارزم,2020-07-27,15090,15820,0.04837640821415663,730
وخارزم,2020-07-28,15740,15090,0.04129606098848183,650
وخارزم,2020-07-29,16490,15740,0.045482110367163,750
وخارزم,2020-08-01,17300,16490,0.046820809245848506,810
وخارزم,2020-08-02,18760,17300,0.07782515991056368,1460
وخارزم,2020-08-03,18080,18760,0.03761061946694631,680
وخارزم,2020-08-04,18130,18080,0.002757859900564928,50
وخارزم,2020-08-05,19030,18130,0.047293746713226816,900
وخارزم,2020-08-09,19980,19030,0.04754754754516779,950
وخارزم,2020-08-10,20610,19980,0.030567685588036502,630
وخارزم,2020-08-11,20160,20610,0.022321428570321357,450
وخارزم,2020-08-12,20580,20160,0.020408163264314473,420
وخارزم,2020-08-15,19680,20580,0.045731707314749404,900
وخارزم,2020-08-16,18700,19680,0.052406417109496985,980
وخارزم,2020-08-19,18440,18700,0.014099783079495673,260
وخارزم,2020-08-22,17550,18440,0.050712250709361126,890
وخارزم,2020-08-23,16680,17550,0.05215827337816797,870
وخارزم,2020-08-24,15850,16680,0.05236593059606524,830
وخارزم,2020-08-25,15510,15850,0.021921341068863873,340
وخارزم,2020-08-26,16220,15510,0.04377311960272669,710
وخارزم,2020-08-31,15410,16220,0.052563270600093234,810
وخارزم,2020-09-01,14690,15410,0.0490129339653497,720
وخارزم,2020-09-02,14140,14690,0.038896746814788066,550
وخارزم,2020-09-05,13480,14140,0.04896142432871206,660
وخارزم,2020-09-06,13130,13480,0.02665651180299646,350
وخارزم,2020-09-07,12720,13130,0.0322327043999817,410
وخارزم,2020-09-08,12270,12720,0.03667481662292789,450
وخارزم,2020-09-09,11670,12270,0.05141388174366633,600
تمحركه,2018-01-15,1449,1451,0.0013802622488749052,2
تمحركه,2018-01-16,1445,1449,0.002768166088049712,4
تمحركه,2018-01-17,1431,1445,0.009783368267097576,14
تمحركه,2018-01-20,1409,1431,0.015613910563794242,22
تمحركه,2018-01-21,1396,1409,0.009312320910234727,13
تمحركه,2018-01-22,1395,1396,7.168458776223327e-4,1
تمحركه,2018-01-23,1388,1395,0.005043227662072602,7
تمحركه,2018-01-24,1410,1388,0.015602836868366781,22
تمحركه,2018-01-27,1397,1410,0.009305654968285143,13
تمحركه,2018-01-28,1427,1397,0.021023125423249384,30
تمحركه,2018-01-29,1401,1427,0.01855817272051522,26
تمحركه,2018-01-30,1445,1401,0.03044982696854683,44
تمحركه,2018-01-31,1426,1445,0.013323983160361862,19
تمحركه,2018-02-03,1488,1426,0.04166666663866487,62
تمحركه,2018-02-04,1492,1488,0.0026809651456561894,4
تمحركه,2018-02-05,1526,1492,0.02228047180715565,34
تمحركه,2018-02-06,1509,1526,0.011265738892468031,17
تمحركه,2018-02-07,1503,1509,0.00399201596540784,6
تمحركه,2018-02-10,1513,1503,0.006609385322796176,10
تمحركه,2018-02-12,1531,1513,0.011757021546860208,18
تمحركه,2018-02-13,1506,1531,0.016600265593226915,25
تمحركه,2018-02-14,1499,1506,0.004669779850120227,7
تمحركه,2018-02-17,1478,1499,0.01420838970621895,21
تمحركه,2018-02-18,1462,1478,0.010943912441214834,16
تمحركه,2018-02-19,1453,1462,0.006194081207024031,9
تمحركه,2018-02-21,1499,1453,0.030687124729361488,46
تمحركه,2018-02-24,1488,1499,0.00739247311331151,11
تمحركه,2018-02-25,1485,1488,0.0020202020188416145,3
تمحركه,2018-02-26,1542,1485,0.03696498052077498,57
تمحركه,2018-02-27,1602,1542,0.03745318349722023,60
تمحركه,2018-02-28,1630,1602,0.017177914099890848,28
تمحركه,2018-03-03,1600,1630,0.01874999998828125,30
تمحركه,2018-03-04,1603,1600,0.0018714909532928938,3
تمحركه,2018-03-05,1659,1603,0.033755274241256614,56
تمحركه,2018-03-06,1686,1659,0.01601423486594648,27
تمحركه,2018-03-07,1611,1686,0.046554934794193086,75
تمحركه,2018-03-10,1539,1611,0.04678362570059543,72
تمحركه,2018-03-11,1520,1539,0.012499999991776315,19
تمحركه,2018-03-12,1447,1520,0.05044920521738133,73
تمحركه,2018-03-13,1413,1447,0.024062278822319687,34
تمحركه,2018-03-14,1410,1413,0.0021276595729591064,3
تمحركه,2018-03-17,1412,1410,0.001416430593897712,2
تمحركه,2018-03-18,1460,1412,0.03287671230624883,48
تمحركه,2018-03-19,1516,1460,0.03693931395980256,56
تمحركه,2018-03-25,1516,1516,0,0
تمحركه,2018-03-26,1515,1516,6.600660061649729e-4,1
تمحركه,2018-03-27,1518,1515,0.0019762845836783366,3
تمحركه,2018-03-28,1515,1518,0.0019801980184949186,3
تمحركه,2018-04-03,1507,1515,0.005308560049562999,8
تمحركه,2018-04-04,1495,1507,0.00802675584747374,12
تمحركه,2018-04-07,1484,1495,0.007412398916838005,11
تمحركه,2018-04-08,1456,1484,0.019230769217561283,28
تمحركه,2018-04-09,1413,1456,0.030431705569404312,43
تمحركه,2018-04-10,1400,1413,0.009285714279081632,13
تمحركه,2018-04-11,1372,1400,0.020408163250431367,28
تمحركه,2018-04-15,1373,1372,7.283321189159998e-4,1
تمحركه,2018-04-16,1395,1373,0.01577060930769132,22
تمحركه,2018-04-17,1424,1395,0.020365168525024457,29
تمحركه,2018-04-18,1421,1424,0.002111189301821823,3
تمحركه,2018-04-21,1457,1421,0.024708304718800065,36
تمحركه,2018-04-22,1487,1457,0.02017484867506735,30
تمحركه,2018-04-23,1483,1487,0.0026972353319641026,4
تمحركه,2018-04-24,1512,1483,0.019179894167209062,29
تمحركه,2018-04-25,1513,1512,6.609385322796175e-4,1
تمحركه,2018-04-28,1513,1513,0,0
تمحركه,2018-04-29,1461,1513,0.035592060208355876,52
تمحركه,2018-04-30,1462,1461,6.839945275759271e-4,1
تمحركه,2018-05-01,1432,1462,0.020949720655761367,30
تمحركه,2018-05-05,1456,1432,0.016483516472195387,24
تمحركه,2018-05-06,1455,1456,6.872852228953366e-4,1
تمحركه,2018-05-07,1430,1455,0.017482517470291944,25
تمحركه,2018-05-08,1431,1430,6.988120190783983e-4,1
تمحركه,2018-05-09,1452,1431,0.014462809907394758,21
تمحركه,2018-05-12,1488,1452,0.02419354837083767,36
تمحركه,2018-05-13,1558,1488,0.044929396633549806,70
تمحركه,2018-05-14,1619,1558,0.03767757872904411,61
تمحركه,2018-05-15,1653,1619,0.020568663024459366,34
تمحركه,2018-05-16,1646,1653,0.004252733897780842,7
تمحركه,2018-05-19,1627,1646,0.011677934842238514,19
تمحركه,2018-05-20,1549,1627,0.05035506775316006,78
تمحركه,2018-05-21,1507,1549,0.027869940260205745,42
تمحركه,2018-05-22,1509,1507,0.0013253810461727096,2
تمحركه,2018-05-23,1492,1509,0.011394101869038805,17
تمحركه,2018-05-26,1469,1492,0.015656909451560987,23
تمحركه,2018-05-27,1454,1469,0.010316368631144174,15
تمحركه,2018-05-28,1454,1454,0,0
تمحركه,2018-05-29,1453,1454,6.882312452248925e-4,1
تمحركه,2018-05-30,1440,1453,0.009027777771508486,13
تمحركه,2018-06-02,1434,1440,0.004184100415492259,6
تمحركه,2018-06-03,1441,1434,0.004857737678794075,7
تمحركه,2018-06-09,1483,1441,0.028320970985623077,42
تمحركه,2018-06-10,1551,1483,0.04384268211228711,68
تمحركه,2018-06-11,1534,1551,0.011082138193557927,17
تمحركه,2018-06-12,1539,1534,0.0032488628958746825,5
تمحركه,2018-06-13,1561,1539,0.014093529779568527,22
تمحركه,2018-06-17,1638,1561,0.047008546979848256,77
تمحركه,2018-06-18,1637,1638,6.108735488021542e-4,1
تمحركه,2018-06-19,1623,1637,0.00862600122697104,14
تمحركه,2018-06-20,1647,1623,0.014571948989330934,24
تمحركه,2018-06-23,1686,1647,0.023131672584144915,39
تمحركه,2018-06-24,1736,1686,0.028801843301381424,50
تمحركه,2018-06-25,1811,1736,0.04141358363257118,75
تمحركه,2018-06-26,1726,1811,0.04924681341295086,85
تمحركه,2018-06-27,1661,1726,0.039133052354525556,65
تمحركه,2018-06-30,1584,1661,0.04861111108042227,77
تمحركه,2018-07-01,1633,1584,0.030006123680339176,49
تمحركه,2018-07-02,1555,1633,0.05016077167192233,78
تمحركه,2018-07-03,1554,1555,6.435006430865503e-4,1
تمحركه,2018-07-10,1502,1554,0.034620505968961046,52
تمحركه,2018-07-11,1443,1502,0.040887040858706133,59
تمحركه,2018-07-14,1435,1443,0.005574912888101105,8
تمحركه,2018-07-15,1452,1435,0.0117079889726529,17
تمحركه,2018-07-16,1446,1452,0.00414937759049144,6
تمحركه,2018-07-17,1465,1446,0.012969283267597758,19
تمحركه,2018-07-25,1437,1465,0.019485038260622797,28
تمحركه,2018-07-28,1426,1437,0.00771388498757792,11
تمحركه,2018-07-31,1496,1426,0.04679144381898967,70
تمحركه,2018-08-01,1438,1496,0.040333796912146176,58
تمحركه,2018-08-04,1372,1438,0.04810495623315965,66
تمحركه,2018-08-05,1316,1372,0.04255319145702645,56
تمحركه,2018-08-06,1265,1316,0.040316205501726314,51
تمحركه,2018-08-07,1301,1265,0.02767102226927669,36
تمحركه,2018-08-08,1282,1301,0.014820592812152422,19
تمحركه,2018-08-11,1272,1282,0.007861635213945254,10
تمحركه,2018-08-12,1284,1272,0.009345794385244707,12
تمحركه,2018-08-13,1265,1284,0.01501976283397647,19
تمحركه,2018-08-14,1261,1265,0.0031720856437969184,4
تمحركه,2018-08-15,1251,1261,0.007993605109517502,10
تمحركه,2018-08-18,1240,1251,0.008870967734781477,11
تمحركه,2018-08-19,1284,1240,0.03426791274589726,44
تمحركه,2018-08-20,1273,1284,0.008641005492033773,11
تمحركه,2018-08-21,1299,1273,0.02001539644340616,26
تمحركه,2018-08-25,1360,1299,0.044852941143490484,61
تمحركه,2018-08-26,1373,1360,0.009468317545907998,13
تمحركه,2018-08-27,1350,1373,0.017037037024417008,23
تمحركه,2018-08-28,1336,1350,0.01047904190832407,14
تمحركه,2018-08-29,1343,1336,0.005212211462984205,7
تمحركه,2018-09-01,1379,1343,0.02610587380267884,36
تمحركه,2018-09-02,1371,1379,0.0058351568155834005,8
تمحركه,2018-09-03,1351,1371,0.014803848989782493,20
تمحركه,2018-09-04,1346,1351,0.0037147102498404825,5
تمحركه,2018-09-05,1383,1346,0.026753434543200696,37
تمحركه,2018-09-08,1445,1383,0.042906574364770536,62
تمحركه,2018-09-09,1500,1445,0.03666666664222222,55
تمحركه,2018-09-10,1527,1500,0.01768172886857778,27
تمحركه,2018-09-11,1500,1527,0.017999999987999997,27
تمحركه,2018-09-12,1560,1500,0.03846153843688362,60
تمحركه,2018-09-15,1637,1560,0.047037263257765874,77
تمحركه,2018-09-16,1639,1637,0.001220256253068788,2
تمحركه,2018-09-17,1676,1639,0.02207637230186374,37
تمحركه,2018-09-18,1756,1676,0.04555808653442022,80
تمحركه,2018-09-22,1783,1756,0.01514301737793437,27
تمحركه,2018-09-23,1844,1783,0.03308026028574823,61
تمحركه,2018-09-24,1878,1844,0.01810436633753761,34
تمحركه,2018-09-25,1971,1878,0.0471841704479025,93
تمحركه,2018-09-26,2028,1971,0.028106508861880417,57
تمحركه,2018-09-29,2208,2028,0.0815217390935137,180
تمحركه,2018-09-30,2312,2208,0.04498269894248153,104
تمحركه,2018-10-01,2374,2312,0.02611625946667386,62
تمحركه,2018-10-02,2290,2374,0.03668122269140558,84
تمحركه,2018-10-03,2188,2290,0.04661791588362984,102
تمحركه,2018-10-06,2082,2188,0.05091258402934074,106
تمحركه,2018-10-07,2068,2082,0.0067698259154884794,14
تمحركه,2018-10-08,2066,2068,9.680542105672536e-4,2
تمحركه,2018-10-09,1963,2066,0.052470708073117316,103
تمحركه,2018-10-10,1891,1963,0.03807509252349281,72
تمحركه,2018-10-13,1889,1891,0.0010587612487777864,2
تمحركه,2018-10-14,1889,1889,0,0
تمحركه,2018-10-15,1801,1889,0.04886174344871641,88
تمحركه,2018-10-16,1750,1801,0.02914285712620408,51
تمحركه,2018-10-17,1682,1750,0.04042806180711768,68
تمحركه,2018-10-20,1740,1682,0.03333333331417624,58
تمحركه,2018-10-21,1777,1740,0.0208216094424189,37
تمحركه,2018-10-22,1719,1777,0.033740546809924055,58
تمحركه,2018-10-23,1655,1719,0.038670694840682356,64
تمحركه,2018-10-24,1579,1655,0.04813172891188617,76
تمحركه,2018-10-27,1501,1579,0.05196535639442681,78
تمحركه,2018-10-28,1451,1501,0.03445899377363267,50
تمحركه,2018-10-29,1523,1451,0.04727511487375238,72
تمحركه,2018-10-31,1591,1523,0.042740414806574215,68
تمحركه,2018-11-03,1546,1591,0.02910737384921903,45
تمحركه,2018-11-04,1539,1546,0.004548408054224556,7
تمحركه,2018-11-05,1584,1539,0.028409090891155876,45
تمحركه,2018-11-06,1573,1584,0.0069930069885613426,11
تمحركه,2018-11-10,1568,1573,0.0031887755081704237,5
تمحركه,2018-11-11,1544,1568,0.015544041440709817,24
تمحركه,2018-11-12,1578,1544,0.021546261076333166,34
تمحركه,2018-11-13,1562,1578,0.010243277842353855,16
تمحركه,2018-11-14,1546,1562,0.010349288479722323,16
تمحركه,2018-11-17,1519,1546,0.017774851864532683,27
تمحركه,2018-11-18,1453,1519,0.0454232621848429,66
تمحركه,2018-11-19,1465,1453,0.008191126274272268,12
تمحركه,2018-11-20,1499,1465,0.0226817878434411,34
تمحركه,2018-11-21,1530,1499,0.02026143789525396,31
تمحركه,2018-11-24,1533,1530,0.001956947161150067,3
تمحركه,2018-11-26,1466,1533,0.04570259205613738,67
تمحركه,2018-11-27,1479,1466,0.008789722779722972,13
تمحركه,2018-11-28,1414,1479,0.045968882570036146,65
تمحركه,2018-12-01,1377,1414,0.026870007242650682,37
تمحركه,2018-12-02,1415,1377,0.02685512365593277,38
تمحركه,2018-12-03,1465,1415,0.03412969280946778,50
تمحركه,2018-12-04,1508,1465,0.028514588840507563,43
تمحركه,2018-12-05,1561,1508,0.03395259446896054,53
تمحركه,2018-12-08,1573,1561,0.007628734896612374,12
تمحركه,2018-12-09,1513,1573,0.03965631193677705,60
تمحركه,2018-12-10,1481,1513,0.021607022267652244,32
تمحركه,2018-12-11,1481,1481,0,0
تمحركه,2018-12-12,1479,1481,0.0013522650430343034,2
تمحركه,2018-12-15,1425,1479,0.03789473681551246,54
تمحركه,2018-12-16,1418,1425,0.004936530320919231,7
تمحركه,2018-12-17,1454,1418,0.02475928471474602,36
تمحركه,2018-12-18,1452,1454,0.0013774104673709294,2
تمحركه,2018-12-19,1395,1452,0.040860215024472964,57
تمحركه,2018-12-22,1415,1395,0.01413427560838567,20
تمحركه,2018-12-23,1432,1415,0.011871508371598108,17
تمحركه,2018-12-24,1457,1432,0.017158544943611156,25
تمحركه,2018-12-25,1460,1457,0.0020547945191405517,3
تمحركه,2018-12-26,1464,1460,0.0027322404352921855,4
تمحركه,2018-12-29,1510,1464,0.03046357613876584,46
تمحركه,2018-12-30,1518,1510,0.005270092223142232,8
تمحركه,2018-12-31,1490,1518,0.018791946296112787,28
تمحركه,2019-01-01,1473,1490,0.011541072633033894,17
تمحركه,2019-01-02,1454,1473,0.013067400266115956,19
تمحركه,2019-01-05,1518,1454,0.042160737785137854,64
تمحركه,2019-01-06,1593,1518,0.0470809792548142,75
تمحركه,2019-01-07,1654,1593,0.036880290183264636,61
تمحركه,2019-01-08,1736,1654,0.047235023014265534,82
تمحركه,2019-01-09,1783,1736,0.026360067287515384,47
تمحركه,2019-01-12,1836,1783,0.028867102380791338,53
تمحركه,2019-01-13,1814,1836,0.012127894149874368,22
تمحركه,2019-01-14,1900,1814,0.045263157870914124,86
تمحركه,2019-01-15,1832,1900,0.03711790390987014,68
تمحركه,2019-01-16,1796,1832,0.020044543418683437,36
تمحركه,2019-01-19,1818,1796,0.012101210114355769,22
تمحركه,2019-01-20,1749,1818,0.03945111490025665,69
تمحركه,2019-01-21,1664,1749,0.05108173073853261,85
تمحركه,2019-01-22,1633,1664,0.01898346600184723,31
تمحركه,2019-01-23,1705,1633,0.04222873897816496,72
تمحركه,2019-01-26,1649,1705,0.033959975722280183,56
تمحركه,2019-01-27,1700,1649,0.029999999982352938,51
تمحركه,2019-01-28,1636,1700,0.03911980437706613,64
تمحركه,2019-01-29,1630,1636,0.0036809815928337533,6
تمحركه,2019-01-30,1691,1630,0.03607332936956042,61
تمحركه,2019-02-02,1727,1691,0.02084539662950469,36
تمحركه,2019-02-03,1678,1727,0.029201430256733354,49
تمحركه,2019-02-04,1701,1678,0.013521457957953287,23
تمحركه,2019-02-05,1777,1701,0.042768711287130716,76
تمحركه,2019-02-06,1746,1777,0.017754868260163304,31
تمحركه,2019-02-10,1826,1746,0.0438116100526771,80
تمحركه,2019-02-12,1799,1826,0.015008337957193809,27
تمحركه,2019-02-13,1808,1799,0.00497787610344144,9
تمحركه,2019-02-16,1831,1808,0.01256144182820238,23
تمحركه,2019-02-17,1771,1831,0.03387916429481696,60
تمحركه,2019-02-18,1732,1771,0.022517321003165516,39
تمحركه,2019-02-19,1709,1732,0.013458162660352158,23
تمحركه,2019-02-20,1683,1709,0.015448603674718595,26
تمحركه,2019-02-23,1695,1683,0.007079646013522332,12
تمحركه,2019-02-24,1707,1695,0.0070298769730346355,12
تمحركه,2019-02-25,1686,1707,0.012455516006847262,21
تمحركه,2019-02-26,1667,1686,0.011397720449071553,19
تمحركه,2019-02-27,1676,1667,0.005369928397750639,9
تمحركه,2019-03-02,1678,1676,0.0011918951125197287,2
تمحركه,2019-03-03,1665,1678,0.007807807803118433,13
تمحركه,2019-03-04,1719,1665,0.03141361254717067,54
تمحركه,2019-03-05,1710,1719,0.0052631578916589716,9
تمحركه,2019-03-06,1658,1710,0.03136308803898487,52
تمحركه,2019-03-09,1693,1658,0.020673360885603446,35
تمحركه,2019-03-10,1717,1693,0.013977868366931934,24
تمحركه,2019-03-11,1724,1717,0.004060324823630902,7
تمحركه,2019-03-12,1800,1724,0.04222222219876543,76
تمحركه,2019-03-13,1844,1800,0.02386117135365446,44
تمحركه,2019-03-16,1815,1844,0.015977961423703602,29
تمحركه,2019-03-17,1795,1815,0.01114206127512977,20
تمحركه,2019-03-18,1771,1795,0.013551665717926783,24
تمحركه,2019-03-19,1744,1771,0.015481651367269695,27
تمحركه,2019-03-25,1819,1744,0.041231445826700686,75
تمحركه,2019-03-26,1909,1819,0.047145102123025084,90
تمحركه,2019-03-27,1981,1909,0.03634528014318764,72
تمحركه,2019-03-30,2015,1981,0.016873449123139726,34
تمحركه,2019-03-31,1925,2015,0.04675324672895935,90
تمحركه,2019-04-06,1980,1925,0.027777777763748596,55
تمحركه,2019-04-07,2065,1980,0.04116222758297229,85
تمحركه,2019-04-08,2096,2065,0.01479007632882153,31
تمحركه,2019-04-09,2163,2096,0.030975496980593854,67
تمحركه,2019-04-10,2177,2163,0.006430868164248568,14
تمحركه,2019-04-13,2114,2177,0.029801324489214135,63
تمحركه,2019-04-14,2196,2114,0.0373406192908285,82
تمحركه,2019-04-15,2305,2196,0.04728850323328048,109
تمحركه,2019-04-16,2410,2305,0.043568464712212256,105
تمحركه,2019-04-17,2519,2410,0.043271139323830435,109
تمحركه,2019-04-20,2644,2519,0.0472768532347667,125
تمحركه,2019-04-22,2776,2644,0.047550432259527944,132
تمحركه,2019-04-23,2856,2776,0.028011204471984873,80
تمحركه,2019-04-24,2952,2856,0.03252032519223566,96
تمحركه,2019-04-27,2913,2952,0.013388259521665549,39
تمحركه,2019-04-30,2943,2913,0.010193679914986858,30
تمحركه,2019-05-01,3089,2943,0.04726448687365993,146
تمحركه,2019-05-04,3180,3089,0.02861635219225901,91
تمحركه,2019-05-05,3041,3180,0.04570864845586694,139
تمحركه,2019-05-06,2889,3041,0.052613361006364365,152
تمحركه,2019-05-07,2787,2889,0.036598492990097424,102
تمحركه,2019-05-08,2671,2787,0.04342942716457154,116
تمحركه,2019-05-11,2782,2671,0.03989935296912317,111
تمحركه,2019-05-12,2767,2782,0.005421033608449211,15
تمحركه,2019-05-13,2899,2767,0.045532942378222516,132
تمحركه,2019-05-14,2949,2899,0.016954899960340827,50
تمحركه,2019-05-15,2868,2949,0.028242677814420268,81
تمحركه,2019-05-18,3004,2868,0.04527296935909688,136
تمحركه,2019-05-19,3154,3004,0.04755865566025407,150
تمحركه,2019-05-20,3311,3154,0.047417698566168016,157
تمحركه,2019-05-21,3476,3311,0.04746835441672372,165
تمحركه,2019-05-22,3536,3476,0.016968325787056468,60
تمحركه,2019-05-25,3695,3536,0.04303112312773177,159
تمحركه,2019-05-26,3863,3695,0.043489515909011255,168
تمحركه,2019-05-28,3964,3863,0.0254793138179921,101
تمحركه,2019-05-29,3922,3964,0.010708822026846298,42
تمحركه,2019-06-01,3894,3922,0.007190549561584348,28
تمحركه,2019-06-02,3755,3894,0.03701731024313787,139
تمحركه,2019-06-03,3727,3755,0.007512744832972164,28
تمحركه,2019-06-08,3877,3727,0.03868970852754973,150
تمحركه,2019-06-09,4070,3877,0.04742014740849628,193
تمحركه,2019-06-10,4272,4070,0.047284644183688045,202
تمحركه,2019-06-11,4435,4272,0.036753100329931655,163
تمحركه,2019-06-12,4656,4435,0.0474656357286371,221
تمحركه,2019-06-15,4648,4656,0.0017211703954988875,8
تمحركه,2019-06-16,4476,4648,0.03842716710490903,172
تمحركه,2019-06-17,4379,4476,0.02215117606253684,97
تمحركه,2019-06-18,4456,4379,0.017280071809407525,77
تمحركه,2019-06-19,4630,4456,0.03758099351240151,174
تمحركه,2019-06-22,4749,4630,0.025057906922497805,119
تمحركه,2019-06-23,4961,4749,0.04273331988656857,212
تمحركه,2019-06-24,5092,4961,0.025726630002803095,131
تمحركه,2019-06-25,5203,5092,0.021333845854058456,111
تمحركه,2019-06-26,5116,5203,0.017005473022477426,87
تمحركه,2019-06-30,5032,5116,0.01669316374866988,84
تمحركه,2019-07-01,4910,5032,0.02484725050410443,122
تمحركه,2019-07-02,4728,4910,0.03849407782603763,182
تمحركه,2019-07-08,4949,4728,0.04465548594773581,221
تمحركه,2019-07-09,4723,4949,0.04785094218762419,226
تمحركه,2019-07-10,4494,4723,0.05095683131932424,229
تمحركه,2019-07-13,4332,4494,0.037396121875023974,162
تمحركه,2019-07-14,4548,4332,0.04749340368348869,216
تمحركه,2019-07-15,4617,4548,0.014944769327497342,69
تمحركه,2019-07-16,4388,4617,0.05218778485592803,229
تمحركه,2019-07-23,4174,4388,0.05126976520094159,214
تمحركه,2019-07-24,4009,4174,0.04115739584905029,165
تمحركه,2019-07-27,3931,4009,0.019842279313191994,78
تمحركه,2019-07-28,4062,3931,0.0322501230841334,131
تمحركه,2019-07-29,4265,4062,0.047596717456601004,203
تمحركه,2019-07-30,4440,4265,0.03941441440553729,175
تمحركه,2019-07-31,4490,4440,0.01113585745854435,50
تمحركه,2019-08-03,4528,4490,0.008392226146556487,38
تمحركه,2019-08-04,4748,4528,0.046335299063535104,220
تمحركه,2019-08-05,4935,4748,0.037892603842372315,187
تمحركه,2019-08-06,5176,4935,0.046561050995641215,241
تمحركه,2019-08-07,5404,5176,0.04219096964430219,228
تمحركه,2019-08-10,5674,5404,0.04758547760881468,270
تمحركه,2019-08-11,5954,5674,0.04702720859136258,280
تمحركه,2019-08-13,6250,5954,0.047359999992422394,296
تمحركه,2019-08-14,6562,6250,0.04754647972454336,312
تمحركه,2019-08-18,6628,6562,0.009957754977375112,66
تمحركه,2019-08-19,6298,6628,0.05239758652708835,330
تمحركه,2019-08-21,6191,6298,0.017283152961188313,107
تمحركه,2019-08-27,6502,6191,0.04783143647372632,311
تمحركه,2019-08-28,6347,6502,0.02442098628888908,155
تمحركه,2019-08-31,6474,6347,0.019616929252453362,127
تمحركه,2019-09-01,6545,6474,0.010847975552200462,71
تمحركه,2019-09-02,6773,6545,0.03366307396520551,228
تمحركه,2019-09-03,7099,6773,0.04592196083308607,326
تمحركه,2019-09-24,6973,7099,0.018069697401682246,126
تمحركه,2019-09-25,6625,6973,0.05252830187886365,348
تمحركه,2019-09-28,6294,6625,0.052589768024691806,331
تمحركه,2019-09-29,6141,6294,0.024914509033558945,153
تمحركه,2019-09-30,6432,6141,0.04524253730639886,291
تمحركه,2019-10-01,6122,6432,0.050637046708487905,310
تمحركه,2019-10-02,5819,6122,0.05207080253444392,303
تمحركه,2019-10-07,5529,5819,0.05245071440541676,290
تمحركه,2019-10-08,5735,5529,0.035919790752237175,206
تمحركه,2019-10-09,5984,5735,0.04161096255989121,249
تمحركه,2019-10-12,5959,5984,0.004195334787012026,25
تمحركه,2019-10-13,5697,5959,0.045989117071091955,262
تمحركه,2019-10-14,5449,5697,0.04551293814543715,248
تمحركه,2019-10-15,5211,5449,0.04567261561203749,238
تمحركه,2019-10-16,4951,5211,0.05251464349575547,260
تمحركه,2019-10-23,4992,4951,0.008213141023995764,41
تمحركه,2019-10-26,5173,4992,0.034989367864877365,181
تمحركه,2019-10-28,5424,5173,0.046275811200907846,251
تمحركه,2019-10-30,5695,5424,0.04758560139638532,271
تمحركه,2019-11-02,5812,5695,0.020130763933219067,117
تمحركه,2019-11-03,5857,5812,0.007683114220986321,45
تمحركه,2019-11-04,5924,5857,0.011309925723951734,67
تمحركه,2019-11-05,6084,5924,0.02629848783262681,160
تمحركه,2019-11-09,6233,6084,0.023905021655077005,149
تمحركه,2019-11-10,6053,6233,0.02973732033211014,180
تمحركه,2019-11-11,5911,6053,0.024023007947213158,142
تمحركه,2019-11-12,5887,5911,0.004076779343625483,24
تمحركه,2019-11-13,6042,5887,0.025653757029848765,155
تمحركه,2019-11-16,5968,6042,0.01239946380489285,74
تمحركه,2019-11-17,5670,5968,0.05255731921471652,298
تمحركه,2019-11-18,5450,5670,0.04036697246965743,220
تمحركه,2019-11-19,5603,5450,0.02730679992373607,153
تمحركه,2019-11-20,5826,5603,0.03827669069030609,223
تمحركه,2019-11-23,5731,5826,0.016576513694542574,95
تمحركه,2019-11-24,5644,5731,0.015414599572038518,87
تمحركه,2019-11-25,5766,5644,0.02115851543164091,122
تمحركه,2019-11-26,5663,5766,0.018188239445843503,103
تمحركه,2019-11-27,5844,5663,0.03097193702413211,181
تمحركه,2019-11-30,6136,5844,0.04758800520736831,292
تمحركه,2019-12-01,6442,6136,0.04750077614909953,306
تمحركه,2019-12-02,6706,6442,0.03936773038482438,264
تمحركه,2019-12-03,6940,6706,0.033717579245862016,234
تمحركه,2019-12-04,7287,6940,0.04761904761251282,347
تمحركه,2019-12-07,7651,7287,0.0475754803231505,364
تمحركه,2019-12-08,7936,7651,0.03591229838257153,285
تمحركه,2019-12-09,8107,7936,0.021092882691366364,171
تمحركه,2019-12-10,7977,8107,0.016296853451636346,130
تمحركه,2019-12-11,7899,7977,0.009874667678202978,78
تمحركه,2019-12-14,7817,7899,0.010489957782974292,82
تمحركه,2019-12-15,7578,7817,0.03153866455112976,239
تمحركه,2019-12-16,7906,7578,0.041487477859665126,328
تمحركه,2019-12-17,8236,7906,0.04006799416706314,330
تمحركه,2019-12-18,8050,8236,0.02310559005924154,186
تمحركه,2019-12-21,7979,8050,0.008898358189134183,71
تمحركه,2019-12-22,8044,7979,0.008080556935842795,65
تمحركه,2019-12-23,7961,8044,0.010425825899959072,83
تمحركه,2019-12-24,8085,7961,0.015337043906575504,124
تمحركه,2019-12-25,8082,8085,3.7119524865488797e-4,3
تمحركه,2019-12-28,8124,8082,0.00516986705992493,42
تمحركه,2019-12-29,8308,8124,0.022147327874079522,184
تمحركه,2019-12-30,8723,8308,0.04757537543877389,415
تمحركه,2019-12-31,8994,8723,0.030131198573478853,271
تمحركه,2020-01-01,8944,8994,0.005590339892040436,50
تمحركه,2020-01-04,8705,8944,0.02745548535009127,239
تمحركه,2020-01-05,8270,8705,0.052599758155671125,435
تمحركه,2020-01-07,7857,8270,0.052564592076802266,413
تمحركه,2020-01-08,7720,7857,0.017746113987338587,137
تمحركه,2020-01-11,7874,7720,0.019558039113594355,154
تمحركه,2020-01-12,8054,7874,0.02234914328006591,180
تمحركه,2020-01-13,8389,8054,0.039933245912512426,335
تمحركه,2020-01-14,8297,8389,0.0110883451836702,92
تمحركه,2020-01-15,8049,8297,0.030811280900632215,248
تمحركه,2020-01-18,8394,8049,0.04110078627101491,345
تمحركه,2020-01-19,8435,8394,0.004860699465932341,41
تمحركه,2020-01-20,8484,8435,0.005775577557075014,49
تمحركه,2020-01-21,8886,8484,0.045239702898352496,402
تمحركه,2020-01-22,9330,8886,0.047588424432198455,444
تمحركه,2020-01-25,9796,9330,0.04757043690816962,466
تمحركه,2020-01-26,9757,9796,0.003997130265040778,39
تمحركه,2020-01-28,9859,9757,0.010345876862729904,102
تمحركه,2020-02-01,9796,9859,0.006431196406040098,63
تمحركه,2020-02-02,10059,9796,0.026145740130614797,263
تمحركه,2020-02-03,10518,10059,0.04363947518124743,459
تمحركه,2020-02-04,10362,10518,0.015055008684129028,156
تمحركه,2020-02-05,10104,10362,0.02553444180269849,258
تمحركه,2020-02-08,9817,10104,0.02923500050634257,287
تمحركه,2020-02-09,9831,9817,0.001424066727553243,14
تمحركه,2020-02-10,9418,9831,0.04385219791422253,413
تمحركه,2020-02-12,9747,9418,0.033753975578767415,329
تمحركه,2020-02-15,9659,9747,0.009110673981870723,88
تمحركه,2020-02-16,9473,9659,0.01963475139663942,186
تمحركه,2020-02-17,9201,9473,0.02956200412677296,272
تمحركه,2020-02-18,9164,9201,0.004037538192488265,37
تمحركه,2020-02-19,9556,9164,0.04102134783999358,392
تمحركه,2020-02-22,9675,9556,0.012299741600795892,119
تمحركه,2020-02-23,10124,9675,0.04435005926073192,449
تمحركه,2020-02-24,10591,10124,0.044094042107063164,467
تمحركه,2020-02-25,11120,10591,0.04757194244176511,529
تمحركه,2020-02-26,11617,11120,0.04278212963391735,497
تمحركه,2020-02-29,11326,11617,0.025693095530134814,291
تمحركه,2020-03-01,11886,11326,0.04711425205728468,560
تمحركه,2020-03-02,12432,11886,0.043918918915386185,546
تمحركه,2020-03-03,13039,12432,0.04655264973950819,607
تمحركه,2020-03-04,13407,13039,0.027448347875926878,368
تمحركه,2020-03-07,14032,13407,0.04454104902761252,625
تمحركه,2020-03-09,13542,14032,0.036183724705642906,490
تمحركه,2020-03-10,14128,13542,0.04147791619185462,586
تمحركه,2020-03-11,14272,14128,0.010089686097947751,144
تمحركه,2020-03-14,14044,14272,0.01623469097007728,228
تمحركه,2020-03-15,14096,14044,0.003688989784074277,52
تمحركه,2020-03-16,14368,14096,0.01893095768242407,272
تمحركه,2020-03-17,13869,14368,0.03597952267387847,499
تمحركه,2020-03-18,13377,13869,0.03677954698087915,492
تمحركه,2020-03-24,12806,13377,0.04458847414925906,571
تمحركه,2020-03-25,13262,12806,0.034383954152135125,456
تمحركه,2020-03-30,13888,13262,0.045074884789381126,626
تمحركه,2020-04-04,14197,13888,0.021765161652337453,309
تمحركه,2020-04-05,14906,14197,0.047564739028071595,709
تمحركه,2020-04-06,15198,14906,0.0192130543479923,292
تمحركه,2020-04-07,15827,15198,0.03974221267203246,629
تمحركه,2020-04-08,16359,15827,0.03252032520126411,532
تمحركه,2020-04-11,15639,16359,0.0460387492777007,720
تمحركه,2020-04-12,15907,15639,0.016847928583840578,268
تمحركه,2020-04-13,15268,15907,0.04185223997629996,639
تمحركه,2020-04-14,14745,15268,0.03546965072665516,523
تمحركه,2020-04-15,15142,14745,0.02621846519441167,397
تمحركه,2020-04-18,15798,15142,0.04152424357250764,656
تمحركه,2020-04-19,15284,15798,0.033629939804133084,514
تمحركه,2020-04-20,14904,15284,0.025496511002046664,380
تمحركه,2020-04-21,15352,14904,0.029181865553075698,448
تمحركه,2020-04-22,16119,15352,0.04758359699438032,767
تمحركه,2020-04-25,16857,16119,0.04378003203157264,738
تمحركه,2020-04-26,17159,16857,0.017600093244501423,302
تمحركه,2020-04-27,16797,17159,0.021551467522679557,362
تمحركه,2020-04-28,16070,16797,0.045239576848460514,727
تمحركه,2020-04-29,16627,16070,0.03349972935385218,557
تمحركه,2020-05-02,17417,16627,0.04535798357665741,790
تمحركه,2020-05-03,18286,17417,0.047522694955292426,869
تمحركه,2020-05-04,17522,18286,0.0436023284988242,764
تمحركه,2020-05-05,17002,17522,0.030584637099718582,520
تمحركه,2020-05-06,16302,17002,0.042939516621093146,700
تمحركه,2020-05-09,17103,16302,0.046833888788701754,801
تمحركه,2020-05-10,16880,17103,0.013210900473151013,223
تمحركه,2020-05-11,16488,16880,0.023774866568184446,392
تمحركه,2020-05-12,16055,16488,0.02696979134058114,433
تمحركه,2020-05-13,15683,16055,0.02371995153837149,372
تمحركه,2020-05-16,16287,15683,0.03708479154926722,604
تمحركه,2020-05-17,16704,16287,0.02496408045827562,417
تمحركه,2020-05-18,17076,16704,0.021784961347986357,372
تمحركه,2020-05-19,17615,17076,0.03059892137209203,539
تمحركه,2020-05-20,18144,17615,0.02915564373737017,529
تمحركه,2020-05-23,18799,18144,0.03484227884276598,655
تمحركه,2020-05-26,18676,18799,0.006585992717574106,123
تمحركه,2020-05-27,17972,18676,0.0391720454017821,704
تمحركه,2020-05-30,17680,17972,0.016515837103138243,292
تمحركه,2020-05-31,17858,17680,0.009967521558407015,178
تمحركه,2020-06-01,18351,17858,0.026865020978319165,493
تمحركه,2020-06-02,18850,18351,0.0264721485397097,499
تمحركه,2020-06-06,19276,18850,0.02210002075004669,426
تمحركه,2020-06-07,20014,19276,0.03687418806650973,738
تمحركه,2020-06-08,20825,20014,0.03894357742910235,811
تمحركه,2020-06-09,21524,20825,0.03247537632259453,699
تمحركه,2020-06-10,21914,21524,0.017796842200520357,390
تمحركه,2020-06-13,22510,21914,0.026477121278255127,596
تمحركه,2020-06-14,23150,22510,0.027645788335738844,640
تمحركه,2020-06-15,24220,23150,0.044178364985789496,1070
تمحركه,2020-06-16,24980,24220,0.030424339470359312,760
تمحركه,2020-06-20,26190,24980,0.04620084001350894,1210
تمحركه,2020-06-21,26860,26190,0.024944154876212057,670
تمحركه,2020-06-27,27960,26860,0.03934191702291338,1100
تمحركه,2020-06-28,29240,27960,0.043775649793304526,1280
تمحركه,2020-06-29,30110,29240,0.028894055130226037,870
تمحركه,2020-06-30,30860,30110,0.024303305248726398,750
تمحركه,2020-07-01,32320,30860,0.045173267325334984,1460
تمحركه,2020-07-04,33730,32320,0.04180254965781789,1410
تمحركه,2020-07-05,34510,33730,0.022602144305343318,780
تمحركه,2020-07-06,35720,34510,0.03387458006624091,1210
تمحركه,2020-07-07,36370,35720,0.017871872421834703,650
تمحركه,2020-07-08,36530,36370,0.004379961675215441,160
تمحركه,2020-07-11,34710,36530,0.05243445692732831,1820
تمحركه,2020-07-12,35890,34710,0.03287823906288999,1180
تمحركه,2020-07-13,36480,35890,0.016173245613591743,590
تمحركه,2020-07-14,37390,36480,0.02433805830370853,910
تمحركه,2020-07-15,38860,37390,0.03782810087396222,1470
تمحركه,2020-07-18,39900,38860,0.026065162906614908,1040
تمحركه,2020-07-19,38120,39900,0.046694648477264046,1780
تمحركه,2020-07-20,36940,38120,0.03194369247341788,1180
تمحركه,2020-07-21,36540,36940,0.01094690749833205,400
تمحركه,2020-07-22,36210,36540,0.009113504556500594,330
تمحركه,2020-07-25,34750,36210,0.042014388487999585,1460
تمحركه,2020-07-26,33200,34750,0.04668674698654558,1550
تمحركه,2020-07-27,31560,33200,0.051964512038911136,1640
تمحركه,2020-07-28,30670,31560,0.0290185849354738,890
تمحركه,2020-07-29,29220,30670,0.04962354551507106,1450
تمحركه,2020-08-01,29760,29220,0.018145161289712865,540
تمحركه,2020-08-02,30750,29760,0.03219512195017252,990
تمحركه,2020-08-03,31730,30750,0.030885597225626043,980
تمحركه,2020-08-04,31400,31730,0.010509554139792689,330
تمحركه,2020-08-05,29960,31400,0.04806408544565874,1440
تمحركه,2020-08-09,29180,29960,0.02673063742197633,780
تمحركه,2020-08-10,28410,29180,0.027103132698799607,770
تمحركه,2020-08-11,28110,28410,0.010672358590869001,300
تمحركه,2020-08-12,27430,28110,0.024790375500372205,680
تمحركه,2020-08-15,27300,27430,0.004761904761730333,130
تمحركه,2020-08-16,27220,27300,0.0029390154297230337,80
تمحركه,2020-08-17,27060,27220,0.005912786400372772,160
تمحركه,2020-08-18,26040,27060,0.03917050691093815,1020
تمحركه,2020-08-19,26010,26040,0.0011534025374412378,30
تمحركه,2020-08-22,25240,26010,0.03050713153603379,770
تمحركه,2020-08-23,25210,25240,0.0011900039666326852,30
تمحركه,2020-08-24,25180,25210,0.0011914217632568935,30
تمحركه,2020-08-25,24350,25180,0.03408624229839482,830
تمحركه,2020-08-26,23530,24350,0.03484912877029966,820
تمحركه,2020-08-31,23250,23530,0.012043010752170192,280
تمحركه,2020-09-01,23150,23250,0.004319654427459194,100
تمحركه,2020-09-02,23100,23150,0.002164502164408463,50
تمحركه,2020-09-07,23100,23100,0,0
تمحركه,2020-09-08,23080,23100,8.665511264789189e-4,20
تمحركه,2020-09-09,22780,23080,0.013169446882652789,300
